天::峻极倚盖十瑞有赫穹窿照临莽莽星榆垂象碧落金阙帝宫再旦大圆覆盆六气无私溥博覆焘苍苍月桂观文青霄瑶台神阙左旋玉京四时玉仪张弓圆盖有象临下得一圆碧披雾刚健管窥断鼇银阙九野铜浑圆盖覆奁无声听卑函三轻清昭云高明盆望倚剑居高荡荡高覆一元广大浩浩杳杳穹苍风驷积气补石盖高手捧设位巍巍健行万物清明高高昭昭虚碧云车垂形戴盆不息翼搏磨行撑柱壶中折柱示谴网疏盘古分无私覆成万物分清气屈原问车运叫阑瓮里绝维亏盈石炼女娲补不可升覆群生仰至仁秦穆观披云睹统元气雷霆震共工触临下有赫潜施造化雨露霑濡万象森罗外炼石几年补坐井观刻象形日月明杞国忧覆物无私密浑阴阳风雷鼓舞群生复育中乘槎何处登垂象示群动火流空外日何言行四时峰耸望中云
日::五色阳精火精千里合璧扶桑华曜久照东升九光君象阳德十煇联珠细柳灵光重明西没出地乌飞炳耀出海羲驭大明赫赫火轮两珥无私分阴暵暵葵霍丽天驹过光芒丽空乌轮临照曈曈铜柱重轮有节寸晷晖晖桑榆伺晷羲鞭宣光仰照棠阴隆照悬车三舍继照弹丸晨曦线量负暄测圭羿射浮彩依光桑荫宣明弭节再中离章冠珥夕照绳系树表君象则戾常右转五色备太阳宗东门朝似骐步虞公指白虹贯周文梦阳宗方中出东方四海明群阴伏西谷饯类凫飞夸父追赤乌飞汉武生云间五色满圭影旋当午入帘光易透散彩宜偏照清明开晓镜光从天上落霞际九光披羲轮恰正中过隙景难留流阴信不追照晰辨秋毫恩向日边来
初日::旸谷咸池若木杲杲旭旭车盖沧海赪玉霞举镜开曙景晻暧丹穴一轮将出海扶桑曈曈昕昕铜钲赤波金轮露晞轮涌晨光曈昽鞠陵五色已光天金乌升晓气晓光升海峤散熳添和气鲜飙收晚翠才分天地色玉槛漾晨曦宿霭散曈昽曈昽卷似烟佳气满晴空便禁虎狼心
日影::花重长短竹影升沉穿帘透树离离倒影穿窗步晷圭测测影竹间花阶宫线轻冉冉下危簷醮水隔帘叠叠流光过隙寸阴线量惜阴花柳陌棠阴重迟迟浮曲砌添一线帘横玉筋随波上下波摇碎影光筛竹径栏槛重阴合参差三径竹葵藿常倾向惜寸阴水碎金波逐树横斜树透微光影透书帏楼台一片明狼藉半窗纱桑榆任转移
斜阳::绳系返照余辉半规峰隐孤鹜带西连山鹭影归舟鸟外穿小阁戈挥末光残影片影山啣悲笳落景入巷蝉声宿鸟林梢上高堂横烟紫斜入户夸父逐鴈声远明千丈门关暝色半窗横薄影葵藿心犹在照叶丹半啣山鲁阳挥鸦背明抹半楼笠带斜阳远岸测微光桑榆景已沉天际催归容夹岸秋沙白带帆归别渚林边促暮鸦连山晚照红随客上荒城
春日::葵光杲杲阳和丽色沙暖暖晖柳影迟迟暖气晴光泥融晴昼明媚和暖缓驾烘花莺戏怯寒韶光江山丽花心绽破寒威暖吐花唇冲融舒徐载阳筛柳蝶飞逗暖霁景鱼鸟繁柳眼开回淑气晴舒柳眼布回暖气晴飞燕子水成嫩碧熙有登台乐暄和催鸟韵影迟红杏坞消尽寒光暖睡鸳鸯花变新红舒回化国长明丽压花梢光转绿杨堤红雨春思绿茵客愁年光莺语鸟声啼鸟莺啼蝶困蝶蕊雄蝶飞花莺燕飘燕花明栽花春色燕忙花气落花燕语莺慵莺林蛮莺啼鸟蛙鱼去鸿柳媚斗草画楼花影柳重红英菖叶碧桃花信柳絮药阑梁苑池塘入眼古意红树浪痕花迟绿叶榆钱绿笋酒痕梨花柳径隋隄庭院侵眉春愁诗债弄晴寂寥好梦野云巷陌别院深巷钓竿倚楼携酒客怀日迟离愁乘暖憔悴残花春浪帘栊归期隔帘帘箔欹枕赏花羁恨昼永步履诗情画楼诗思莺无语江山丽愁夜雨乱春思红锦丽诗卷春光老登临酒思红树梦魂花乱飞草木芊怨春莺生客愁画屏开雨声中白日长沽酒市蚕消息蝴蝶梦东风采吹愁却难忘酒花心折偎红倚翠青帝辞权卖花声蜂课程杜鹃魂北斗城惹恨长尽属诗柳眼开痛饮狂歌东君远别寻芳醉客青山如故春色有情一别从今日一杯浓琥珀眼底风光好呼客鸟声巧拾翠佳人袖风光客愁无奈相逢又隔年三揖旧莺花杯心酒面浓喷人花气香园林迎眼媚客愁茅店雨风送棋声远世态浮云变芹泥随燕嘴风景著人和诗思柳桥春日回花影重春愁细草生花蕊上蜂须
夏日::尧曦盾日炽日日长炎光烁石郁蒸火炽热气可畏乌流威酷行南陆戈停鲁骄阳景短畏景烧空炎赫金流炎晖如焚龟折景长经中街辔缓羲炎可畏云生火蒸千里槐阴密流辉赫赫祝融司令人间居火宅一轮腾汉表景偏长汗滴珠煽八荒柳影浓永昼炎炎炎帝当权何处饮冰壶万里炽炎威炎威驰迥野桐阴迟昼景昼永停羲驭畏景烁长空竹荫却炎光时和韵舜弦桐阴玉簟脱巾枕凉围棋纵步山禽避暑齐纨梅风荷气银塘挥尘林密摇扇披襟溪女寻凉湘簟蕉雨抱琴红药甘瓜冷泉柳子池塘竹径浮瓜羽扇荷香竹深荷盖烹茗垂钓绿篁素藕幽石荔枝楼阁槐庭沉李纱窗柳影荷净稻巾吟诗茶瓶林泉麈柄青奴歌骚观周易朝雨树堂上燕竹抛箨消永日双鹭下棋局枕簟枰黄嬭临帖鼓舜琴晚风荷座间蝇松坠花引清风一蝉鸣儿争爇栗竹径风清月侵竹簟新裁宝扇槐阴清院宇树好频移榻梅黄雨扑地客曝残书兰池气爽风度衣篝偃卧湘筠香篆上帘栊云奇不下楼水白鹤横天树色烟明灭蝉声风抑扬
秋日::金伏清光皜皜爽气清景南郊火流素影凄凄清晖素商西陆寒叶影清碧梧露白气清玉露晷促桐阴薄昧谷纳消酷暑菰蒲熟菊花篱晓霜光冷丹桂江澄晷短金风天高柳影疏扶桑升乱清晖芦苇黄芙蓉径浮江练华承露掌西陆清晖爽影挂如霞树露从朝晷散金紫三竿影散露珠影逐霜蹄南郊暑气疏光摇似练江烟带夕阳微乌飞八月天霁晓云收虹销烟收云容玉宇新秋雨霁雾卷云歛风气银河鴈宇橙黄蓼红江澄红叶清风归石燕送断云黄花呈色白云红叶荷蕖红潋滟蛩吟橘绿芦白潦净黄花素月渡边鸿收残雨丹桂飘香秋水长天苔径碧逶迤鸟归林霭瞑日月波中浴蜗涎归壁重簷雨收残溜楼射涧虹明云霞窗里窥燕嘴得泥轻城阴带暮曛客怀老鬓宦情诗怀壮志归梦归心诗思归兴短吟秋思秋霜异乡西风鴈书孤枕鴈字落叶揽镜白云黄花砧急悲雄剑别愁夕照故国落日蝶梦单衣孤声鸣蝉伤吟红叶白发鴈来揽蔽裘书中蠹双鬓雪楼头笛西风扇南枝鹊懒贳酒秋光换三更雨碧云注目向秀闻笛雨后蝇雨京尘天外舟落日砧北塞鸿倦登楼晓镜看一笛风黄叶销魂王粲登楼青灯相对诗怀爱秋洁老松经岁叶梦绕边城月乱雨疏灯外白发消穷达白发几茎客意怯霜寒寒菊过时花心怀故国楼清霜古镜边青山傲古今鹊噪渔唱夜乌河鹭砧杵松菊梧落肃肃玉宇苔花老催酒笛蟏蛸网角鸣鴈声霜叶陇云芭蕉山河桂开凄凄银河树叶疏捣秋砧蟋蟀声云淡淡收松子蝉噪晚金茎有露白云连野燕辞巢去雨荒篱菊红树醉秋色雨丝丝割蜜房鴈惊寒玉宇无尘碧水接天菊冒雨开霜倒池莲碧潭浮夜弦风冷衣裳脆扇闲知暑退池馆风烟淡林浅数枝月天寒笔砚清衣薄惜秋深郊虚气象新发冷一梳风
冬日::雪霁霜融云收冰释凄凄南至催短暖气云散向暖烘窗经簷晴消寒去岭雪气暖雪消烈烈西沉增长寒晖霜凝负暄炙背过隙暖破暖来江梅冰融经簷短浮霁色冰如泮暖入幽窗历历寒风雪霁乾坤光摇碧瓦披裘灞岸枝暖出雾迟夺寒威草欲苏光回寒谷萧萧晴雪风消宇宙影落茅簷拥步蓝关窗梅横月横窗梅影瘦已添唐宫绣未消埋径雪负暄人曝背帘雪飞花入户竹阴疏何须邹律吹先暖读书帏乘暖客登舟冰玉出户雪声风刀携籐寒梦御寒狐裘赏雪曝背藏钩纸帐冰生砚琼树炉中火收松实寻梅踏雪遣兴乌帽寻梅围炉煮茗红炉雪满天冻玉虹砌下霜辨梅诗煮茗敲冰风摇槛竹草木摇落雪玉树池被风前浪篆沙依碧水老笻偕瘦影冬日傍窗暖雪映江梅门巷萧疏冰作瑶池山埋雪后峰积雪破青山寒木凭吟身晓霜舖砌浓杜老应怀白王猷想访安煮茗摇落偿酒债炭索价登山屐云酣酿雪梅自知春近寻梅萧疏入醉乡酒论文折海图梅吐横春松应耐岁寒残雪松梢落秃木风难响橘帖临窗看经冰涧水凝寒云日易蹉梅诗信笔书
日蚀::阴盛萦丝晦昧阳微代鼓遮蒙妖物乌足折如月之初蔽乌天眼翳类钩不尽流泽融和茅簷南檐向阳阳和雪消和入背负暄浩荡竹屋晓景快炙霁色冻解暖侵肤横窗堪曝背入户罢围炉
月::水气冰镜丹桂玉槛扬彩金波玉兔结璘入河蟾魄三珥金精玉盘素娥金环飞光玉宇琼蟾纤阿捣药蛾眉重轮西生游园似钩庾楼升沉婵娟金兔流天鹊飞一轮应潮上弦朒朓东落照牖如璧潘室圆缺皎洁银蟾照室牛喘千里离毕破镜朏魄牛渚阴灵皎皎桂华瑶盘轮影影冷冰轮涌离沧海离海角照潘室袁宏渚南楼坎德胧胧璧彩玉碗镜光光寒玉斧修上碧霄出云头鉴阮帏庾亮楼清似水如泼水寒色迥穿绣幕宝镜莹光影横玉塔追随落日轮移金殿光腾五彩迥无云似开奁瑞光呈逼纱窗桂花浮影光射金梯点缀浮云镜挂画楼影耸千寻空函万象入牖人偏揽桂含秋树晚渐出三山上一轮光正满山明疑有雪深泱重渊临枝鹊正飞影入夜池寒将凌一汉横万里气尤清岸白不关沙
新月::兔爪蛾眉玉缺曲钩半抹弓势隐隐学扇破环楼外映水怯钩如璧缺金波浅菱花缺银钩分镜一弯梳形纤纤磨镰缺璧天边凌空疑弓似眉弯桂叶偏璧彩亏眉光巧光如爪白潭鱼惊钩落微升古塞外云畔风生爪未满十分势指甲新曲似眉弯云鴈怯弓张已引春云端沙头水浸眉先形一曲光
残月::弯弓破镜残云晕缺景淡蓂落轮亏将坠影微晨起如新淡淡光暗气沉光渐减昃轮气沉光微桂残鉴缺余光轮缺西倾误拜纤纤影斜轮昃影将斜沉海底金镜缺老桂欹非为雾迷镜匣微开气清仍泛露匣破光微露残波犹泛魄上云端玉钩纤纤钩侧宁关云掩帘钩残挂光淡即迎曦轮斜影半亏疏桂不盈轮
月影::兔魄玉彩蟾华光浮散彩入帘光摇皎洁练白映阶筛庭竹桂华金波桂影色泻流辉穿户彩照婆娑波寒透竹映槛花光含宇宙高映南楼飞上寒窗皓彩临庭交如绿牖满衣冰彩如金晃耀水漾金波碎色界窗櫺斜穿北牖照来虚阁清光入户掩映朱帘遍地梅魂似玉玲珑云分缟带长清辉延细竹穿帘疑碎璧下阶嫌履湿爽气集幽兰入户觉镕金闭户认苔生
月桂::仙枝灵种不老一株香满皎洁密叶清香长生万古根高婆娑兔窟玉宇玉枝清虚府风霜古飘宇宙丹霄日唯蟠月窟根非生下土皓魄澄虚镜蟾宫瑷柯金粟广寒宫岁月多照山河白兔宫不碍山河叶不坠秋风天香遍一轮叶凝终古碧映月无他影讵作婆娑态蕊结九秋红扶风有异香还看湛露频
等待::凭槛登临倚楼栏边倚槛凝情卷帘携酒凝望江上停杯伫立极目望久登楼看褰翠箔望穷沧海峤自是登楼早深防有云起玉轸临风久倾心吟余倚槛观卷珠帘倚遍碧栏干非关出海迟共望此轮高金轮出雾迟
赏月::登楼供赏举杯星稀浮杯面无云无雨素娥寻旧约冰镜光初满泛渚当歌卷帘云静入诗肠如雪如霜玉兔索新诗玉楼饮自豪
散步::中庭皓彩花影独步顾影光炯夜徘徊踏花影炉香初泛夜蝉辉微吟寒衾影随人迤逦步廊西花影欲摇春
中秋月::秋光金饼似昼桂魄银盘如霜午夜至晚经年夜半弦管饮兴袁渚银色中秋此时金茎玉宇露华重一轮通宵彻夜秋长杯盘诗豪庾楼金风半夜今夜桂子琼楼桂子飘月华满千里共平分秋色九秋今夕半桂香清透露星辰让光彩莫辞终夕看秋色分十分圆长伴云衢万里一轮圆金气冷含风风露发晶英动是隔年期
乌云::风妒雾凝云妒薄暮云翳隐兔埋光雨阻老雨罢赏爽约寂寥深沉云浮云锁雨昏积阴烟昏藏蟾晦影云生农云成愁愆期怅望寂寞今夕素魄蟾华没空好句秋寂寂空寂寞辜吟望空对酒妨啸咏空期夜月片云闲云兔魄沉谩登楼夜漫漫绝光辉负赏期懒登楼怨黄昏羞对西风庭花失影浮沉桂魄此生此夜桂树婆娑最是分明月嫦娥还负约玉宇偏萧索月桂无香埋没蝉光行雨行云梧桐点滴翻成点淡秋佳节却无情金樽阻献酬对酒愁偏积棹倚袁宏渚敲诗兴不长帘垂庾亮楼
夜月::欲满今宵一夕轮欲满千里共轮未满将圆来夜九分笔独擎九分明镜欠圆二七今宵清光未满今夕试看伫看今夜只争一夕早定知金镜袅已知千里共三五明夜素影尚亏来宵定赏尚欠一分恰作九分圆应烦玉斧修犹讶一分亏天意将圆夜人心待满时皎洁轮减光琰昨夜赏心分寸减尤皎洁酬酩酊婵娟光亏影斜今宵饮兴等闲看尚团圞减婵娟银色三千里免闲长捣药如何一日隔最怜新缺后金风二八里桂老尚生枝便减半分圆全胜未圆时
月蚀::金蟆朦胧渐掩山河景玉兔混沌齐闻金鼓声
星::水精四守度缠入房贯珠经纬银烁陨石石质天孙垂野在东疏密金气五行珠缀聚井连贝盈缩榆光流虹金精婺女在天环北有无周环聚东磊磊次舍布列炳炳荧荧编珠象纬瑞彩井聚炳耀天阶森列共北煌煌宫垣森罗辉辉历历散锦珠玑光芒阶平昭回帝座三台武库重曜灿烂聚奎流虹铺碎玉千珠络光连璧月珠光连璧月五老文昌丽天光辉食昴陨石灿明珠一局彩耀银河榆影澯银河观象明尧历流辉悬玉李森然居次舍垂光罗列宿未得灵槎便呈祥验石经布算扪金针烂石拱辰庭腾耀布干文空瞻紫极端
景星::合星辉辉助月炳炳瑞应祥光炳耀为瑞治世中天皇图永中天象腾赤气助月明丽天光炳焕祥开瑞彩光芒应时明时下国君寿延半月形烛圆灵增人寿助月著晶莹光映一轮月美瑞争先睹史奏贤人聚烛宵何灿灿华澄五色云清辉有烂垂时占下国宁助月独荧荧
老人星::天躔依丙垂休垂瑞帝寿近丁作瑞为祥灼烁瑞彩皎洁春夕祥瑞春见增辉灿灿连牛斗依狼地含规同月满昭彰祥光光芒秋宵寿昌秋明发曜荧荧煇丙丁近帝城表瑞得天清祥为一人寿南极垂光夜火星连北地精芒明鹤发色映九霄明中朝表瑞时瑞彩见南郊祥瑞荐龟年
北斗::天极枢机居北东璧帝居喉舌指南南弧斗纲君象北极揭柄居中星拱扶帝座一台列枢七政候五色龙光射天之枢电绕帝君中天连魁临下宸寰挂天心四辅居运四时运九霄剑气冲学者仰斟酌元气魁建星居北静随银汉转璇玉交辉映三辰扶帝座纲纪三辰衡平柄揭西密拱紫宸居魁杓代斡旋七政总天纲
残月::隐见明灭隐隐有无浮沉莹莹五更天明半灭月斜点点度难正北斗寒光淡九霄孤月畔微云犹辨斗寒落鸡声数点躔次斜沉天晓荧荧天欲明东方曙色分几点五更头落月已啣山光分月影边
河汉::星阙天潢终津清浅含星皎皎耿耿清河一水隐隐析木箕尾仙槎地纪华汉纵横伴月盈盈昭昭斜汉双星迢迢支机女牛西流夜清显晦垂象案户云汉银弯北极水气灵源经年月娥鹊惊左界晓落分明为章成桥银河星汉南滨河精清汉终古星驾槎度月过淡如扫微云淡度牛女千寻直秋深横水气万里通槎路清沉宵雾迥星回直若绳让月明洗甲兵一派长月落浸银河中天倚建章浅淡曙霜寒隐隐寒波泻浅寒浮月色微微素练横清影动星芒
云::触石擘絮从龙润础点缀轻重鹏翼聚散叆靆垂天飞空翼凤度溪往来飞扬鱼鳞卷舒氛氤溶溶西郊蓊郁蔽目曳曳随意变化凌空度关冉冉去来从风溶泄漠漠南浦翻绵弥天扬扬无心纵横映涧出塞悠悠隐显依汉氤氲因风孤飞一片赤鸟楚襄梦腾空外迷野径乘风急相如凌暮宿苍桐伴月重叠千重丹蛇汉武封出岫间罩山峰伴雨生仁杰顾朝飞巫峡碧落从龙起垂天才一缕背将天下望孤飞穿白练凝重风难扫秦岭成诗处白衣触石来拔地忽千重空作日边阴轩举罩青螺堆轻雾与群阳台入梦时
庆云::五彩余光五色呈祥轮囷祥光若烟纷郁盘礡郁郁玉叶扶日符圣治化作奇形六稍为瑞烜赫瑞彩非雾氤氲昭回葱葱金枝起风表昌时散成文锦金柯初缭绕结盖祥光迥飞空初荟蔚起封光更白非烟亦非雾冉冉排空上玉叶渐氤氲为楼翠色分呈瑞渐氛氤复鼎色尤黄成彩复成文依依叠翠重
祥云::于吕起封郁郁凤翥团青纠缦绵渺车盖扶日曳紫流光三元作华盖视嘉气纷纷鸾翔散紫荣光轻翔锦章绕台悬华曜藻五色起封中应太平影散金柯丽呈祥非爱道氤氲扶日月表圣能依日先垂玉叶纷为瑞岂无时灿烂映山河逢时欲逐风
孤云::一片形细来往似鹤孤飞影奇东西随风有象一缕欲消天高逐鸿出岫无心日影单还似鹤望穷千里白光并孤轮月无心九霄将断势薄随月随风得势时势断未从龙点破一天青辉连一抹烟
热::热气炎炎燄燄不雨烧空如火挟日烈焰能蔽日触石有机抱石情虽久炎光炽炽悠悠助阳烁石似峰腾空炎威不成霖从龙无意为霖意若何徒有从龙意势助炎威盛万方思舜泽浑无济物心峰升远汉高四海望商霖
云峰::插汉叠嶂入画似屏峭拔突兀排空重岩题诗如画巍峨崔嵬突起出岫岩势耸拔倚汉封洞来去半天卑衡岳排天外排无际崔巍状森罗成峰磴形嵯峨铺天环峰断连万仞压岱宗列日边叠几重岳岱形移太华千岩秀如危岫浮岚滴随风散藏草木楚岫数重卷舒排玉笋万壑空中落下阳台万仞横遍太虚玉叶开送雨来遍乾坤巫山十二突兀簇芙蓉三山海上横叠嶂神工削逗阴消世愠雨来如曝落浮岚画墨拖倒影浸天池日映似霞明
霞::冠岭流光为裳五色照水雨余晓来明川建标叠帔九光丽天日边晚后朝霁照山孙赋红锦晓迎瑞彩锦绣散朱秋岭布空发彩三光红辉晚晴明水谢诗绛云晚送祥光红绡成绮仙坛冠日腾光五彩瑞彩绛彩日落映鴈咀丹葳蕤琼室郁郁纷纷孤鹜山光残照水气散锦文烂红雨晴分鸦乘紫丽彩赤城轩轩灿灿去鸿野色远空金光沉绿绮来明月冠秋岭明远水浮滕阁开宿雾辉左界光摇地轴应是壶中气入天消惨淡结绣甍收夕霏丽长天灿郾城散余文伴残阳绮散天机长为物外华照水共缤纷五色明如锦天酒和云液远待陵仙幔千重络似花仙衣照月波高疑别海槎
虹::藏见一条五色两垂架天依云见影雌雄万丈千寻双出晕日截雨藏形窈窕高下天陂化玉朝彩壮士偃蹇绚汉云头插空长川剑光星渚纡余浅深斗精吐金晚光美人光华连云雨脚倒海远汉玉色天浔仙客远渚赩赫山顶远近回馆剑影贯日饮涧仙带成文随雨与药老龙遥岑照燎天腰升沉拖轩桥形弥天丽天天弓垂象照云投杯朝影出横碧落乘黄道逸势含良玉瑞彩腾空远截断将沉日一条乘雨后横云仙带阔晚光舒驾晴空架彩桥神光现瑞金长桥跨海低横遮欲雨天五色丽天中渡汉彩桥斜
风::少女封姨飞帘羊角转蕙金铃虎啸铜鸟松涛吹衣眇眇拂野阿那大王巽二箕尾鸿毛起苹玉铎鸢鸣翣脯花信满袖绵绵悬瓢消散喜怒苍梧穆者鹊鸣萧萧飘飖五日驱烟故人袁扇宗悫乘摇玉树出幽涧雌雄黄竹凄其鹢退习习泛漾终朝卷雾君子阮衿列子御响金扇入山户披云罗影散解落三秋叶过江千尺浪传凉入缕槛逐舞飘轻袖召得阴阳顺泛水织文生能开二月花入竹万竿斜发气满瑶阶传歌共绕梁能令惠泽通
春风::解冻吹花泛兰鴈斜融冰淡荡轻拂习习飘红展草落花舒柳催花惊尘转蕙抽麦鸟碎吹雨吹嘘微和微微皱绿鸣条飞絮开花擘柳碧皱拂芳草来水面穿绣幙扬芳经苑囿暖舒莺羽翼声调弦管脆暗催南向叶香飘皱绿波入花心透红楼扶暖入帘栊轻举蝶精神香度绮罗新渐翥北飞鸿
夏风::舜琴袁扇解愠知时拂拂竹边披拂麦陇玉宇松涛荷盖轻拂来院宇唐殿陶窗阜财养物微微荷畔清微槐庭瑶琴麦浪棘心细飘上帘栊消暑气解民愠鸣万籁闲羽扇忘炎暑时送荷香凉生殿阁轻透葛衣物当重巽结涤烦襟吹棘心长幽兰拂金罍远俗氛频摇竹影愠解楼台香来莲沼云逐数峰开渐翥抟扶势诞布清征德民财今巳阜应从橐籥中潜施造化功帝力竟何如
秋风::爽籁萧萧凄凄灏气送暑袅袅凉飙漠漠切切商飙生凉飘飘云飞罢扇萧瑟落叶凉生鴈字生桂吹葭怒号穿林弃扇下叶翻别叶叶下披襟凄凉飞鸿暑退鹏程凋桐塾稻萧索动菊思莼振条败红兰增爽气桂枝生荳翻白送鴈群笛声清白云飞惊沙密黄花满径林敲败叶送秋声苹叶起叶坠丹坠庭叶砧韵响红叶老断柳疏红叶盈沟菊散清香江东归兴扫得天衢净静落阶前叶引笛秋临塞回拂来鸿急林中凋一叶汾上新辞吹来眼界宽清传月下砧吹沙夜遶城斜催别燕高天下动秋声
冬风::飞沙振槁吴江肃杀惨栗舞雪刮地狂飘入幕落木呼号刮天地疾如箭水生骨易水严凝怒号凝冰削天怒震裂窗号空奋发振山冈利似刀地裂肤冷逼重襟黑帝行威肃杀气收群热云壑千岩瘦凛冽穿窗冷冻侵短褐飞廉意气雄威声薄太空霜林万叶飞严凝透户寒
狂风::偃木伐木走石发屋摧林扬沙狂吹拔木怒气摇坤轴起炮车鸟雀惊箕伯号巨浪惊空旷野多惊鸟穿林摧古木怒拂扬尘厉声卷浪头扬沙石蛟龙怒爰居避猛声吹树平林少静柯卷石下危巅并岸漂千舍鱼龙皆失穴连樯覆万船江海欲回流
松风::婆娑轻掠韵生寒声涧底传涧壑龙吟细声瑟瑟潇洒细摇闻乐逸韵树间类笙竽鹤梦清影离离龙蛇动影摇千尺乱摇千尺影似奏琴中曲封标秦岭秀强与幽泉并青山同兴趣风雨寒声撼半天消散半天声如闻涧底声清快楚台雄翻嫌细雨并流水和清音拂空增鹤泪过牖合琴声
竹风::寒声淇涣历历声彻声似荻月明中金影晴摇不移君子操清韵渭川萧萧凉生翠欲流秋色玉声寒戛谩动故人情有韵和宫漏凤尾摇丹槛初疑金罄奏影摇金琐碎无香杂畹兰龙孙舞翠空翻讶凤箫鸣声彻玉玲珑
雨::解作雷送润叶有色海雾屯盈云腾濯枝无声江云黑蜧必夜既零洗甲洒尘决狱利物以润委露霡霂霏微梅黄密洒玄冥崇朝如晦淋铃破块随车为霖其蒙散丝霑雨湍润泽草碧乱飘随风丝汉簷花龙穴山云翻盆洗尘入夜沛然漠漠溅琴暗淡随云润物织空银竹蚁封簷溜淋幔添涨通宵俄尔纷纷添砚空蒙洒道潇潇乱滴霎霎细细风引鹳鸣月离毕滋地脉系瓶马占花石离毕月点点细飘蒙蒙霏霏烟添鱼噞山出云出天津吸砚龙颂宝珠触石云神农师浴猪豨洒四漠阴阳蒸纷如织碧含千里色风鸳藏近渚气连河汉润河伯使滴马騣埋千里日月蔽细若丝青起万家烟雨燕集深条声到竹松高斜影风前合海雾连南极蛛网县珠络圆弦水上开江云暗北津荷盘泻水晶
久雨::决沟谷荒霾云连宵经日屋漏沉灶麦烂积潦累日终旬垣颓伤稼淋沥行潦苔色望霓三日鞭阳石忧伤惨颓邻壁阶滴滴柴薪湿潮漎漎阻程沾濡吹烟蜗涎瞻日九旬洗泥牛恐防游泣瓦沟漏涔涔耒耜闲夜淋淋千里埋烟簷添细滴云上如炊群木水光下藓生台面石水鸟投簷宿无补高天漏百廛涵潦江壮洪涛水喧似瀑万家云气中蜗上壁间琴泥蛙入户鸣何时厚土干
骤雨::黑云紫电怒龙俄尔倒海雷车神鞭密洒迷空盈润破块罩雾白雨黑风掣电沛然倾河天火鬼驭倒倾蔽野喷山倾盆冲风狂风火绳泼墨雷震云浓布昏宇宙横天落鸣池沼万壑轰雷润气凝柱础骇浪银竹悬河电飞水迸流打窗扉卷地流落河鱼半天泼墨繁声注瓦沟雷声惊耳震健涛撞石怒练挂遮簷直电影照窗明猛雨沃山来麻悬倒地齐
夜雨::响竹通宵寒声潇潇霎霎孤馆滴阶彻晓爽气滴滴霏霏青灯乡心半夜聒梦洒竹被冷和蟋蟀衾裯冷惊好梦侵睡幌窗无月照沥沥竹窗客梦五更惊眠敲窗身寒打芭蕉刻漏长感离愁乱寒更壁有蛩声凄凄茅舍气凉生枕玉夜雨西风急窗扉淡欲晓何时对床语疏钟沉远寺声冷逼窗纱孤灯共客心枕簟冷生秋虚听打窗声寒漏断高城
梅雨::细细漠漠冥冥霏霏海雾林阴飞尘鸠唤一番麦疏梅肥霑暍帘卷黄熟优为泽残滴凝珠网江云畦润散雾燕随几阵秧轸础润润花麦穿红肥湿上膏余香上燕泥有无山远近村容青若雾浓淡树高低野色翠如苔
祈雨::祷林积薪诚心虹霓忧心望云迎龙焚驱暴野环艾修德蜥蝎剪爪谒水焚兀王徒市精诚三农桑林谒庙阿电母鞭阴石垂雨露汤致桑林祷未见月离毕泉涸看将竭膏泽六事稻陇请天鞭雷公闭阳门起风雷周歌云汉诗咸思山出云苗焦欲半枯旱气期销荡阴官想骏奔
喜雨::黍育知时救旱相庆春意苏旱荣野一犁油云神力稷生润物为霖交欢恩光贻牟秀田万物沛雨民心谷根苏生悦气苏旱岁为霖雨洗焦枯青覆陇消客恨欢连屋禾苗秀桑麻薿薿嘉蔬润起欢声润枯苗布谷声归造化绿生波兆丰年绿满畴草木肥禾稼芃芃江山霁色散作千村福商羊应屡舞燕尾麦抽穗物自凝膏入时雨二三日村落欢声添成万木阴布谷强多知虾须稻破芽风还逐润吹田家十万金
留客::路遥旅舍依床濡面茅亭半路淋沥云烟对床淹留策笻寂孤馆衣湿萧条投店停骖草舍长途沾濡泥潦惊梦展转高枕萧萧征途云暗邮亭欺短笠嗟去路停客骑无心照滴破乡心云心石磴滑遥指烟村去泥深公馆湿征衣溅征篷阻行程有蛩吟共剪窗烛渡急野桥危频嗟客路难声眠篷底谷声同归梦断寒湿钓来蓑寒逼旅衣单
春雨::濯枝湿柳湿花有泪入眼飞烟润物应候润叶催花添柳无声如膏卷雾生春知时催花卧花一犁陇麦漠漠柳岸蕙叶水生披雨钓红杏重添柳重晨烟湿滋麦剪韭四泽园花蒙蒙花房桃花烟湿带泥耕绿杨垂溅花匀春水生湿梨云翻翠浪肥香菜滋陇麦柳耳添三农庆势密悬麻草痕底映绿燕剪冲帘湿翻桃浪开轻丝渍绿苔湿林莺花脸湿百谷滋声稀鼓瑟水色远浮蓝莺梭织柳迟细添和气润雨细疑无点轻逐暖风吹云低欲近人
夏雨::熟梅暑蒸水声沛若气蒸合洒濯枝梅湿漂麦阳化云色滂然雷送急流拂柳荷沾滋梅却暑雷声濯枝消暑流畎亩飘苹渚三时泽涨江湖消酷暑一天爽湿柳生凉电影润物苏民涨池塘滴稻畦五月秋滋原隰洗炎光万物苏湿桃腮枕簟霜阴浓柳岸暗窗不晓润含琴调水田看浴鹭帘疏蛛网重对面雷嗔柱凝杏脸帘栊雪声战荷池凉簟先秋凉入书声烟树听鸣莺池湿燕泥新当阶雨趋人竹窗滋嫩绿晦野云阴合莲沼洗新红喷山瀑势雄
秋雨::东渚苔黄破晓空蒙疏枝滴阶快冷滴滴西山黍黑催寒潇瑟败叶落叶惊寒潇潇叶声客梦沾草江山冷沾白草滴高梧秋色动寒无寝蛛丝润迷远望暗添簷溜簷溜乡心舞阶枕簟寒渍青苔催败叶雨声频湿未炊薤叶凉送寒声细逐庭梧蝉沉远岸西风来鴈翠璧凝云老苔翻旧碧繁声乱梧叶冷到鸳鸯梦窗寒知气重鴈断长空夜雨鸣蛩绿畴翻浪病叶坠新黄凉气逼书帏清随蟋蟀吟人静觉泥深秋池不自冷风叶共成喧
冬雨::散漫寒声飘空朔吹斜风鴈湿杂霰疏密阁云凝寒溟蒙凉气作雪同云乱洒鸥寒逐风横斜酿雪积冷萧萧飘院落妨获刈成玉筋千山瞑簷溜落迟冷湿岭梅松发结珠冷伴雪花瑟瑟瞑乾坤阻收成散冰丝四野低天风吹急冻寒江水梅腮滴玉冻和云叶但融江路滑布野同云湿梅苑滋新萼溟蒙才洒润严冻随风扇未放野梅芳飘寒冷吹斜松岩湿旧梢点滴不成声浓寒杂雪飘
雪::冰花盈尺粉拂玉叶封条缯铺玉线舞风拂树玉笋琼花银关琼林柳絮散盐剪水呈瑞冷艳扑帘银沙带雨凝阶银盘玉树玉堂瑞木梅花飞絮飞花表祥寒光穿牖闭户平吴梁苑饮酒飘飘积户片片点点袁门黄竹曹衣周咏盐虎乘舟访戴灞桥烹茶密密载涂霏霏纷纷焦寝幽兰班扇郢歌玉龙玉宇瑶阶鹤毛饲马三白璧山麻衣杂沓脉脉粉署鹤冷昭窗侵夜旋阶琼柱蝶粉迎宾六花琪柱纨扇氛氲麃麃琼台麋哀著柱映昼鹤氅千山老争桂魄银河水梅花片屋成玉银作水萦砌落长春苑黎花雨龙鳞百尺同试梅玉柱花柳絮飞月散花玉成林满空飞不夜城柳絮风垂缯户高贤立户千里飞琼狂风柳絮远山银鹤聚一夜寒生骨环佩神工琢种玉田逸士乘舟九霄散玉清压梅花老柱玉龙斜满天风散花晶莹暖日烘三白从今卜暗度南楼月有田皆种玉旄秃龙庭节千仓待此盈寒深北渚云无树不成花衣飘鹤氅仙
晴天::冰筋寒气骑驴登楼玉尘晴光倚杖倚槛凭栏寒去日融初霁新霁玉柱渔舟敲冰庭日照摧冰柱千岩静寒光退卷箔暖来风急未消残冰琼花樵径煮茗簷溜垂散玉尘万壑寒暖气舒帘初卷镕金屑青女有功光销竹瓦望穷眼力晴波落日轮碾三竿色远霭销如洗路渐通瘦玉颜素娥无意冷湿梅花清澈眉峰簷溜垂冰银镕万里光浮云晚更屯万瓦融新白已尽南簷滴千山失旧青仍留北牖苔
雪景::凝云画舫同云天淡江阔楼上黯黯农家僵木珠帘寒露风寒天低江干垂垂江浦风声动气埋山色一派断烟气严惨惨门愁挂玉惨淡天同色气惨初凝候欲觅琼瑶句云气垂寒勒梅花千寻冻雾云重垂垂阁集缾罂缤纷雪共寒云垂欲下时为怜水墨天陇麦呈今瑞未须东廓履牛衣怯夜寒先策灞桥驴
雪声::静夜吟余密洒折竹夜静萧萧淅沥零霰隆冬梦断碎零跳珠梦惊瑟瑟飘萧撒盐飘屋瓦穿窗片支叟赋乱敲窗纸洒窗蚕食叶惊回清睡思银沙轻糁竹歌枕怜飘瓦打簷松泻竹声谢郎诗轻糁竹梢入竹蟹行沙应是扑窗声玉粒乱敲窗拥炉听打松
欢喜::嘉瑞岁稔乘兴和气把酒润物卷帘粉萼登楼酒樽琼瑶清兴丰年民歌读书欢声吟诗及时会客琼花倚槛茶灶桂玉孤吟霏微拂筵片片簌簌滋宿麦天种玉东武会盈尺呈瑞成银世界陇麦冲寒出飘荡入酒霏霏沉沉化遗蝗麦连云灞陵游三白丰年布作玉江山江梅照影斜歌侑金樽醁竹叶旧时酿欢生绮席香梅花何处村
春雪::妒梅压竹润麦迷花燕寂禁暖勒花酒楼润柳埋萱沃梅压柳莺愁添寒折竹歌扇千点整整融曳轻洒飞花迷舞蝶枝枝絮勒花容疑柳絮寒禁柳润竹根尺园斜斜缤纷旋消舞絮逐残梅树树花埋野色讶梅花冷欺花滋蔬甲柳排金线准拟春花少飘来梅共笑已逐东风落地冻萱芽短润从河汉下茶点绛葩依稀柳絮多飞作柳边春还随暖日稀林深鸟弄迟花逼艳阳开
霰::筛瓦跳阶光集碎玉杂雪阳薄渗渗点点临风朔吹星散击瓦鲛泣玉筋结冻下零飘英随风寒凝纷纷飘飘带雨寒声珠倾鸣窗蚌珠冰弦酿寒敲玉随风势疏处漏寒雀啅飘零随雨势点簷珠乱溅随风入疏牖撒珠作雪媒暖边融夜蛾惊散乱助寒威飘瓦玉频敲杂雪下长空
霜::玄冥玉池青女金井遍渚挫物凝条金神芦白铅华铺玉阴凝凝晓封条倒莲气列寒铺沾篱休工杀木玉女菊黄玉屑成花气肃横秋陨药破菊光凝冷缀杀草衾寒丹枫万瓦郊野乘风驷见板桥横陈鹰击棱棱鹧鸪畏践马蹄被庭裘冷黄叶九秋园林带月钟鸣天宇肃杀鴈来肃肃鸿鴈飞覆蚕茧草俱白宵路结瓦生银粟苇深秋渐老驷星初晰晰轻明凝淡月有客呵诗笔叶已黄晓阳晞林缀玉花枫落叶犹黄葭菼复苍苍迢递涨平沙无人送酒钱
露::金茎仙掌玉杯丹棘蝉饮晨降午夜圆明玉润凋枫润柳被兰暖空滴花篱菊金井铜盘蛇游宵寒清秋莹洁珠光滴草滋花垂木迷野缀叶渚莲汉殿曙寒丁地润形团圆湛湛濯濯鹤警聚荷珠错落明彻曙蝉鸣高柳韩窗宵润垂材浣手点缀瀼瀼溥溥蝉鸣缀柳玉玲珑暗生寒鹤警长松夜警千年鹤映日偏知泫玉液含秋皎萦萦缀松盖泛掌光逾净朝零七月风因风半欲零金茎彻夜寒点点滴荷盘添荷滴尚微
甘露::天酒如蜜神浆若饴凝脂灵滋甘流揭云玉聚彩囊成甘五色琼爵润叶呈祥润垂仁泽讶蜜神液膏被垂木珠联宝瓮应瑞千龄金茎沾条愈疾甘溢灵浆良宵浓于酒凝风草先瑞雪婺女匀调蜜浓浓滋禁树散玉呈隋瑞拂曙氛埃歛和气甘若饴滴金盘比祥云鲛人碎泣珠湛湛滴阶蓂凝脂表晋祥凌空沆瀣清脂凝仙掌润献来仁寿晓饴液玉杯明凝处未央秋
雾::飞尘迷漫水溢三里吹沙银山骑鹿洛水水腾迷路氤氲烟回半天喷水丹巘乘龟茂陵地汁蛇游侵窈郁拂林漠漠山市暗迷汉殿作五里困平成随雨密迷柳色豹隐蒙冒依霏度野冥冥晓城昏掩秦楼寒三精迷大泽带烟浮暗花阴文采南山豹树在溪无影带楼疑海气杏园迷宿霭乍似含龙剑威棱北塞貂禽来鹘未知含盖似联云桃径锁层阴还疑映蜃楼
烟::淡笼轻缣淡抹轻锁素练轻笼连云连村凌晨溶泄桑柏孤村随风曳寒五色一抹冉冉漠漠林梢带雾罩树薄暮连绵松篁曲岸掠水引索千寻万条萋萋霏霏天际山市笼江岸迷春草笼残月花借色迎晓日弥漫远岫寒分渡口乍惊香雾薄鱼村映鱼舟锁绿杨罩远村月笼辉锁长空缭绕孤村淡抹山腰遥认断云浮影摇秋水练孤村寒雨后翠色笼寒浦笼花难见蝶岩溪引轻素光夺远山屏幽馆夕阳天微光淡晓村罩柳但闻莺渔市袅孤青
雷::出地起龙崩云发天翻燕送雨破山推车裂地作解一声隐隐虩虩金门神威焦衣倚柱积风霆轰惊蛰引鼓发萌动威百里虺虺阗阗石室天怒失箸凭窗挺物电掣崩荡发声碎磕谢仙火鼓乾坤群阴肃鲸心破龙出穴劲穿江海起龙喷雨震辟掩耳訇棱阿香车驱号令百里惊魅穴空鬼推车怒拔山川含物生春惊破蛟龙声从地穴一鸣天阙晓却碾千山过电光穿壁入震蛰虫蛇出一声天外震催生草木响激天门再鼓禹门开深蟠绝壁来雨势压山来惊枯草木开万物土中生
电::列缺阳光绕枢晃日春发荧煌烨烨烂烂逐雨光照野飞火镜摇玉栋电光火气照野昭天夜舒闪烁煌煌辉辉追风焰流天闪红绡掣金蛇为鞭策掣影奔何疾烂迷星少色闪烁先天际奔狂光自激绕斗枢飞光去不留晃夺月无光荧煌烛物时倏闪影难停
雹::阳愆折木害稼破车阴伏跳阶销金毁瓦锴石掷瓦如斧凝气马头祠井北极如梅李若斧形问可御霸图应表异流铜穿窗似蛎雨冰鸡子都泉西河似杯棬如砺状不为灾圣世想无灾坚嫌银弹小不放随风散著地疑凫卵圆类水晶明须知见日销嬴空讶马头
晴::天晴烟光雾歛云歛霁华天开夕阳日丽日色云收霓收晴色山出落叶晒薪天容地涨蝶舞鸠唤电匿云雾卷开望眼簷溜断人意悦野云归岫曝背物态鸟喧蝉鸣农欣灵舒山屏开散愁眉水痕深物华心霁色澄空日丽花心日上三竿晴岚供眼界槛花明秀色远岫堆螺髻渔歌移远浦林收青蔼薄霁色簇眉峰簷鹊转和声长桥卧彩虹牧笛弄斜阳天出绮霞明沙明排鸟篆水涨蹙龙鳞
晴天::沙软日高斗草眺望明媚花心和气曙光眠芳草人意悦泥融风暖寻芳嬉游阳和柳眼晓光霁色惜落花鸟声碎浮煖艳花含醉千绿媚江山丽桃红柳绿霁色澄空云收雨脚天开六幕暖风丽日爽气融兰蕙日融莺语滑花影重卷轻烟柳起眠万红娇花草香雾卷云收芳草名花阳光淡麦塍风软蝶身轻繁花迎醉客竟日莺相和晚春村外意啼乌唤游人摩霄鹞数群残照水边明
雨后::纵阳纵阳霁色精诚诛蜧闭阴懽情虔祷云阴汤云辍霖歛翳驱云瑶汉三竿日闭阴虽有自精衷祷群望群情厌淫雨溪涨尧日吐景停云推日金炉一穗烟指日更凭人诚意恳灵祠众志望晴晖
旱::赫日旱魃畏日烂石云汉苗槁黄尘赤地酷烈执热民望草木枯赤日流金槁苗土龙骄阳煎沙桑林草枯白日苍生炎蒸乘风草枯金石流断虹截雨火云兴远汉万方思舜泽龟兆初开圻泉涸看将竭剪爪嘉汤后金日烁长空四海望汤霖龙津久闭藏叶焦欲半枯焚巫笑鲁人
春::剪彩花盖宣诏青帝淑景媚景韶景阳和晴沙水解暖日蝶翅柳色寻花蕤囊催花东君良辰芳时香尘日暖春水风和柔风莺声梨花柳塘草香冰开陶柳柳色绿深嫩绿弱柳柳条花红草茸草芽老红花坞云淡风暖潘花梅香黄浅新黄寒梅花影柳绿花绮花蕾稚绿蝶舞鴈北青邻韶华沙暖韶光光风惠风迟日骀荡风迟鸣鴈青芰莺喧燕南紫陌霁色泥融和气丽日膏雨和风鲜妍景丽归鸠绿苹移槛柳柏百紫仓庚鸣泉脉动花心雨桃翻锦红影碎社公雨红杏萼红锦涴登台苔矶千红玄鸟至油幕游柳外烟柳舞线翠光摇花信风绿杨枝碧罗新杏仁雨薰风骨烟花笙歌市风光媚三阳布桃李月丝卷燕艳阳天蝶双飞杨柳风镂冰纹锦绣中锦绣林景色和万物生蕙兰风絮粘蜂明媚景莺百啭花醉露朝迎翠暖风迟日秋千院落蜂翼弄娇野树萋迷绿远烟含树色雪消梅绽玉柳眠风晓映红芳草名花弦管楼台燕泥啣润簷花暗淡红细雨起尘香风细柳摇金风光行处好雨青榆荚地苔痕经雨活云物望中新风白柳花天树色入溪深
早春::雪近麦浪暖日天寒梅残积雪冰开梅东风水暖草动浮烟碎红嫩绿梅坞萱草日寒日暖小雪腊后微暖芳草冰凝穷律变条风发新绿深青桃溪柳条风暖冰消余寒春来嫩寒寒梅梅冻鸟声回淑气微莺迁谷寒消径梅破玉潜报柳桃破蕾冰全破梅粉白先到柳莺初出千嶂雪鴈度关暖入帘雪融银暗惊梅草生芽雪半干柳梢黄暗通梅燕未归一声雷韶光浅寒半减花蕾紫余寒未退桃腮未破倦鸟犹迁木残雪飘梅蕊烟光无处著物色妍煖初回柳梢黄淑气先回柳眼先开潜鱼已陟冰新春入柳枝风景逐时新早嫩侵沙暖鴈外天逾碧雪和新雨落冰轻著雨消鸥边水自春风带旧寒来
春寒::烟浓风撼愁阴冻锁带烟冷雨雨重雾笼冻雨阴缄和雨疏风沉沉剪剪花迟莺倦雨暗鴈藏渚冰犹结莺无语春自老烟暗淡门半掩惨惨阴阴柳困蝶慵烟沉燕守帘雪未干蝶不飞梦初寒雨蒙茸簿低垂疏风冷雨蝶蜂有恨雪瞑迷归鹤柳困多因雨草冻慵抽碧羞满包桃锦阴云低漠漠野草幽花桃李无言春寒误早花花迟半为霜桃痴懒晕红娇愁感柳眉碧树远沉沉
阴天::疏云雨云暗锁雾寒雾合微雨雾薄蝶愁漠漠烟凝重云淡淡密雨烟雾寒痴云暗云蒸密云花愁莺怨沉沉露不干柳沉沉池槛暗锦鸠呼妇风藏戏蝶柳眉不展似雨似风庭淡梨花月草肥连地僻春阴防柳絮树屏藏白蚁排兵露挹幽花花脸羞开轻寒轻暖楼寒燕子风花瘦怯春阴月黑见梨花云暗鸠声急天阴鴈影寒
春色::停骑江碧帝葩一谷浓绿藻香花光韶华青烟带人逐人山青芳草满溪老红花艳柳色霁景绿蔓著物丹青艳杏桃红满江皋催上苑夭桃满红合紫浮草色红映日祥烟起千机锦图画夭桃柳绿浮山外满皇州御柳新白间朱濯年华碧连天瑞气浮一画屏铺秀野堆锦绣烟花芳草合红锦丽杨梅雨红锦绚高低绿满径落花池添嫩碧倚遥天漾琉璃锦绣中野花开绿罗新海棠春绿茵铺浅深红一渠新碧春剪深红蝶留花粉晴梅朱粉色御沟波似叶柳眉横浅碧染云为柳叶野润烟光薄莺惜柳金煖水碧罗光云囿草如茵花脸发深红剪水作梨花沙明日色迟
暮春::催暮将归虹见风花浴沂绿战兰畹花慵绿暗残花莺声蝶恨莺老柳暗落花服成烟柳修褉红酣莲池柳懒红明啼鸟燕语莺愁花残蚕眠飞絮花落地燕争户柳初暗蜂无蜜麦秋雨榆落荚鱼儿出绿榆烟榆荚雨王孙草叶藏禽花入帘荷乍圆燕有泥花信风稻抽秧燕子来红杏雨鲤鱼风少女风麦覆垄莺未老蝉声小连村柳花满路蜂抱花须竹鸡啼罢花容柳眼花明柳暗萍盖鱼蝶初飞蝶翅忙委地花絮飞空鱼吹柳絮杜宇声干紫燕黄蜂日薄云浓雨暗梨花野花红半落水送残花外折花惊蝶梦草色王孙恨笋尖将露角曙分林影外烟沉草色河草绿初平烟迷碧树中留叶待蚕眠禽声帝子魂麦秀欲生须春尽雨声中
春归::泛泛飞雨送春香随水韶景尽蜀鸟鸣残美酒酹攀绿暗莺将老堂堂落花更夏草缀枝暑光催吴蚕食尽新诗赠别红衰蝶已稀榆钱难买住催晓莺犹在酒醒愁难醒柳带莫牵回追晴蝶已稀春归客未归
春晓::火起早起寒光晓星红日烟迷鸟啼晨游啼鸟残月暖风露湿疏雨晓月鸡唱烟重玉绳低鸦翻树天风隐寒生碧树鸣鼍五鼓烟垂柳带晓莺春风蚁浮露浓银漏断燕出巢海月低梦破红楼画角三吹露滴花房花凝清露云钟号晓月碧知湖外草弄晴莺语巧梦随蝴蝶散柳拂春风风絮乱春时红见海东云乘霁燕飞轻魂逐杜鹃飞
春夜::卷帘策杖登榭欹枕揽衣弹琴柳塘楼台困睡媚景花影风清花浓蝶飞围棋酌酒日静风轻庭阴花坞帘幕闲行韶光莺声日丽竹细燕语读易吟诗风暄花暖人静幽斋花初谢迟迟日棋声碎重帘静院沉沉花片片韶光媚春涨地粉蝶喜翠槛日自高寂寂春花影重镇日闲人悄悄雨垂垂丽日晴午晴天蜜蜂喧秋千院落树移午影一炉斜篆燕来燕去珠帘绣户一莺鸣午寂鸟声山寂寂弦管楼台门对春风百尺游丝花谢花开柳絮梨花双燕语春愁花影日重重阶闲看蚁斗燕静啣泥去花小游蜂懒人静听蜂衙蜂喧抱药回日长啼鸟喧
春夜::柳眠漏声繁霜夜静饮散更深草梦花影片月花香睡轻漏促月午枕上灯寒魂觉铜壶沉沉月白半窗花笼月花睡月梨花月风敲竹风清窗前客梦灯残珠箔悄悄花香一枕竹飙风影栖烟柳絮风月在花蝴蝶梦秋千影杨柳月庭花转寒料峭竹影横窗帘卷春风风欺画烛寒侵夜榻子规啼杜鹃声海棠风禁漏传梦阑珊梅花入梦簷垂夜雨雨滴空阶春入晴簷风送竹声浥浥炉香风和花睡足柔风行柳絮有雨夜更静春阴妨柳絮月移花影离离花影月好柳眠迟淡月梦池蛙无风花自香月里见梅花
探春::金谷灞陵携手探春报柳马蹄寻芳踏雪芒鞋茅店载酒折柳烟树寒谷东城奉杯扫雪通梅莺语觅翠寻梅藜杖竹篱邀宾攀梅风花阳坡南陌烟光山桃柳细倚马望眼放柳越岸野服红犹浅苔径滑夸酒好碧眼媚烟草色烟柳梅香乘车吟情生萱穿溪孤帆绿已深酒卮香和春吟绿芽破上柳开牵眼穿云渡水红杏压雪消寒树润吐绿烟坡花留便住绿柳含烟发雪尽青山路桃吐赤心酌酒买鱼乱鸦争树冰动流泉香含红露逢酒醉方归红梅带雪开冰消绿水塘林花都未有草色尚犹无
游春::踏青插花卧酒沽酒坐茵红餤花雨香风柳溪声韵浮白折柳催花携琴步障青骢柳风暖日花径风烟柳桥柳眉硬碧斗草倾城会侣步逐追赏车马柳陌跃马宝马赏心花路花脸软红掷钱盈野邀宾歌随寻芳笙歌花街典衣雕龙乐事看花醉月听莺昼长马嘶草茵花柳早蝶畏风催行酒迎人面舒千萼倚杖寻花驻马春老人醉桃脸绮罗新莺乘暖旋买鱼避马蹄袅万丝盈头翠宜图书留舞袖红粉女天为幕金络马吟风夜春心荡不寒不暖花飞衣袖满手香似管弦驻吟鞍绿衣郎草作茵玉钗人问柳春醉眼迷半醉半醒柳拂征鞍幕天席地眠草衣裳冷兴阑啼鸣唤花娇迷舞袖趣得江山外春风骑马醉衬步芳茵翠酒兴诗情嚼花齿颊香坐久落花多草嫩衬香轮凉生杖履中江月钓鱼歌迎眸淑影新
晚春::老绿柳线把酒扳饯东城落花红愁留连蝶怨莺啼垂老又相送残红榆钱吟诗别离南陌芳草绿惨断送莺愁燕语忘机那肯留空啼树相催急仓庚啼一年花事飘残夜雨晓觉池塘净惜落晖送别离蝴蝶怨九十春光老尽东风春随风雨归
夏::炎精炎帝畏景火德祝融朱明薰风日长槐夏日永戏蝶燕嘴蚕成去燕乳燕寻凉沉李团扇云峰永日宵短麦秋云黄鸣蜩蜂腰麦秀来蝉鸣蝉避暑浮瓜夏云日火槐日绿暗烁石可畏热气赫赫火云莲沼银塘草光密云翠篠簷燕竹风红稀流金如焚炎光炎炎炎气槐庭玉槛荷气青萍红蕖井榴桑畦蕉心荷叶折笋丹鱼水濯枝雨斗指南槐日净蕉叶气鹤避烟桑重绿麦陇葵叶竹竿肥梅黄雀风扇物风日在火麦风清竹花凉蜂啣粉稻正青飞白鹭天将麦竹阴蜜菱蔓滑山果熟榴开碎锦紫李黄瓜池中蒲绿麦含秀色啭黄鹂月正蚕荷叶香藕丝长水荷香云耸奇峰乌纱白葛庭下榴红柳结浓阴晴日暖风绿成夏幄稻花黄雀雨青奴初荐枕麦随风熟绿竿初长笋暗草薰苔径绿阴幽草红驻春山影白鸥波黄嬭亦升堂梅逐雨中黄红颗未开莲晴杨拂石矶槐花清院气松子落阶声
初夏::麦秋献茧鸣蜩清和槐日登麦兰芳荷钱黄梅青麦梅雨吹笙收茧假大荷风熟梅蕙秀麦浪翠柳紫花红药燕新圆荷枣杏陇麦荷花葛巾樱熟蚕欲老双纹簟沙鸥宿鸠唤妇绿槐莺老细麦枇杷岭云槐叶竹簟草芳燕初忙五色瓜江燕归燕将雏梅初熟出巢燕子杨柳长齐梅黄麦熟一年春事了云接奇峰峭出帘初乳燕燕学飞含箨竹孙樱桃烂熟花落莺啼四季雨声多花残碎锦飞映户落残花黄梅江上雨紫椹知蚕老竹篱风陨箨社酒还堪煮白麦陇头秋黄云见麦秋柳径雨飘绵齐纨且莫裁流火金柔鹑火送夏亢阳火老林钟迎秋迅景暑徂温风化霖啸风雁字荷花露蔓畏热火云三伏尽催诗雨炎光凉生溽暑润土漱露云风梧叶风蝉忆凉金月五更寒解愠风逢蕉葛三径柳潜消暑梧桐老火云收凉风发火云倚日莎鸡振羽人间火宅熟荔枝一川榴欲送凉杨柳衰金风起大火流桐叶无风腐草为萤何处冰壶畏日烘窗萤飞清夜月南渡风声老火云收野色泉泓漱白石川原方竭雨薰风拂袖蝉噪夕阳天西回斗柄忙木叶动秋声莲荡落红衣草木渐惊秋
夏夜::月明露沁苦短开轩明月暑月蚊雷月白月凉漏声蛩韵宵静烟景月光似秋纳凉罢扇疏钟炎宵蛙吹天凉风细月影萤光夜凉月华风景如画萤点对月蝉噪漏促脱巾莲沼风生细鸟烛影就佳月槐阴密萤自照虫声扑萤蛙鸣梦沉徙榻月台月上疏林砧声纳凉风帘影疏鸟相呼凉风动孤灯月萤绕户万籁寂荷微动月行花改影荷净香如月竹密风敲玉皓月来细雨天虫鸣阶微云生花乱开风度竹生声槐高色带烟帘疏月缕金蛙吹池中闹挥扇风生竹蚊雷鸣院落萤灯草际飞移床月过庭萤火昭阶庭曲肱宅南鸣雷坦腹窗北梦蝶南柯漆园马槽午阴松窗静梦得句梦蝴蝶觉春醒困一枕黑甜宰予朽木春草槐国蚁穴睡美薤簟凉懒读书傲羲皇酣午梦长五色彩笔吕翁黄梁青奴初荐枕烟袅金炉翠光牖风清处梦魂俱蝶化竹鸡啼正午黄嬭亦升堂帘垂花院深南柯梦熟时鼻息隐雷声蝴蝶梦初甜
干热::流金炽日烂石畏日酷热探汤烁石炎风煎沙骄阳炎蒸坐甑金日烧空赤日蒸爝沸鼎炎炎蕉衣挥房谢扇赐露海波涕难行旅草木焦火云流汗烘云炎焚燎空赫赫葵扇披襟掷瓜颁冰火龙鞭倦游人沙石烂耸云峰石窦寒泉门吟团扇可旱云多酷暑摇舟藏密蒲山川炎似火闭户人高卧张火伞冰壶团扇思对北风图畏日炽炎威行客避邮亭天地气如炉投林鸟倦回
途中::迢递崎岖紫陌驲路征途畏日孤店疲马停骖炎蒸炎热红云蕉裳暑气炎风危桥畏途摇扇黄尘夹道解鞍槐阴密逢蕉葛水泉涸满江云气岭云拱日尘迷去路日气倒侵白汗炎空依树日影迟熟荔枝驿路长夹道日光野树无风汗湿征衣陌尘平抹袖遮尘扑面汗滴缁笠滑红尘芳拂面赫赫日转午衣湿汗翻浆尘点素衣昏赤日困垂鞭凄凄蝉韵高
黎明::曙色月淡柳飞絮草光润薰风烟沉雀嘴雏荷气高竹枝带露晓星稀有数竹清风荐爽鱼倾荷叶露太阳将出海木叶含烟残日淡无辉荷净露生香鸟散竹林风列宿半沉天
秋::白苹白帝在金青女蓐收流火惨淡栗烈天高云歛凉风素节月明殒叶食瓜枫落惊露金天银河清明萧条夜永日晶凄日清商风冷飧英及菽菊开含风璧月珠露金风暑退木零涤暑蝉声荷枯碧梧菊花衣梓红叶秋鹭渔笛衰柳玉云凉生金劲送凉鴈影梧落丹桂桐叶井桐黄花晚蝉客坛寒蒲孤鸿鸣蛙凉露过鴈藏鹭白苹鹊飞金飙北岸笛韵秋色风竹蜗牛一叶归燕秋风闻砧禁蝉红蓼蝉噪珪月东篱砧声寒声露花蟋蟀杨柳月凉暗度玉宇风芦花岸芦花白炎光退风初切云倦碧梧桐月山容瘦芰荷风暑先除金茎露蓼穗汀菊蕊黄爽气浮日正明叶翻黄桂子风鴈影孤千山瘦风外燕乔木老巴云晓庭叶落土鼓迎寒庭梧落叶南亩稻梁凉露落池一鴈横雨中螺乱虫号楚树秋野云飞金神按节岩桂飘香西园风月秋风入树风撼秋声屈平食菊柳老虫书叶树寒烟半拥无树不黄叶萤飞莎径晚空澄横鴈字树增壮气张翰思莼湖平鸟篆沙山湿露还流有山皆翠微蛩响月华初叶细剪风刀微云淡河汉疏雨滴梧桐
初秋::伏火金井涤暑高飙蛩声鴈响荷疏残萤白水玉露新凉银床送凉爽气鴈影风惊树老早雁苍烟银河天迥冷菊金气园林依暑红叶坠叶蝉噪菡萏风清衣襟颢气罢扇山寒残蝉商声砧杵晚风绿莎乱蛩燕归梧桐雨霁枕簟西风登楼残暑迳冷晚花蒹葭浦苔痕紫金掌露金天阔三更雨槐露滴三伏尽凉气入微凉山寒寒叶橘柚村叶晕红白苹风玉宇清七夕秋火星流一味凉暑威收蝉初噪仍御扇秋光早云影薄无限爽暑凌白扇清风扫地雨眠花鸭寒垣榆落鴈欲归却添衣夜色阑露华滋有余香风入清商素月流天露宿莎鸡泽国芦疏一夜西风急溪云迷竹韵旅怀蛩早计水禽孤影白夏衣临晓薄班扇宜捐弃千山黄叶飞野色混秋光凉信柳先知山果半腮红秋影入簷长韩编可卷舒
秋凉::凄日凉风爽籁寒至萧瑟气爽残雨玉露衰柳埋云露零景爽渔笛晓寒水满残暑退清飙凉归寂寥风疏凄风金飙寒蒲藏雨雨霁寒生客毡寒暮山横晚凉生藏秋雨爽气生波深菱穗水云杳杳暑退凉生秋色多因树庭户三更雨寒生帘幙润带晚风炎光谢露冷莲房风雨冥冥水长天远寒声半是溪轩窗一夜风爽入户庭幽江歛洲沙出树润星河露天虚风物清川寒鼓角风
秋色::芦白山峭冷艳枫叶翠浪烟云白云风荷枫丹水清幽姿芦花碧天芦华翠浪水蓼岸竹蓼花岚光红叶画出爽气涧松红蓼山色岩桂莓苔紫红碧叶渚莲芦穗野色黄花收成寒光篱菊白苹水光井梧薜荔红紫黄花篱菊翠秋水碧千林箔暮景龙带晚烟露催黄落丹青霜叶野色青黄秋色入林沼荷香晚霞黄万里明喷残香鴈拖秋色风剪碧鲜水墨烟云云容黑白月光穿竹青黄绕树一帘秋色老烟凝山际紫碧迷烟外草枝枝浓向日无家人易感紫白依栏千里暮云平霞冠日边红翠滴雨余山叶叶翠含霜有笔画难成残叶晚蝉渔笛霖雨万籁闻笛淅沥簌簌惊梦蝉噪寒砧鸣鹤笛韵雁响寒杵急衣砧金风孤鸿捣衣奔腾铮铮伤怀蛩吟短笛咽蝉砧声风惊晓钟催石泉雨风淅淅疑疏雨蛩韵急木叶动天边雁鸣蟋蟀残叶响荷雨带香霜叶风雨潇潇觉寒潮鹤声高寒蝉鸣砌下蛩动梧桐晚蝉鸣荻风含怨微风摆杨柳万壑木声满井梧初坠砌寒塞行行鴈木落闻空谷细雨打芭蕉千岩秋气高寒鴈远鸣空西风杵杵砧蛩吟到纸窗信步煖酒倚栏题诗纫香染露诗成台榭登山清风去燕寒花残菊秋色天霜黄叶登楼摘句吟风赋就园林临水明月来鸿修竹衰荷夕阳江水青山把钓归兴苇风红叶诗飞蝴蝶兰英紫屏转箑张翰莼鲈千山积雨楼台人静后吟情荷露黄花酒泣鹭鹚枫叶红御夹衣渊明松菊一叶西风风月夜凉时梧桐深夜雨画景委红叶渊明方止酒松摇千尺雪气爽衣裳冷西风看梧竹莼脍异乡心月华舖绿苔王粲亦登楼竹撼一窗秋香铺枕簟秋归思入烟波
秋雨::薄雾山色多风天低寂寞雨意黯淡云情淡水云杳杳栖鸦偎树野气苍茫疏阴云容易雨云淡萧疏寒媒冥蒙鴈字成风雨冥冥过鴈贴云水云惨淡云天冥漠重重迷野树不借蛟龙便万木皆萧瑟细雨双飞鹭风景萧疏隐隐暗山城虚成燕雀忙诸山半有无寒蓑独钓船
秋暮::谷熟授衣筑圃荷衰纳火捣衣肃霜黄芦暮商荷风风劲荷枯水寒寒至摇落霜降鲈鱼莼菜疏花寒露红蓼季月菊露霜青菊老木落凉归凄清潭清鸿鴈芦花瘦竹鹤瘦云叶暮色篱菊蓼衰菊枝菊花天青节催水痕收潘安鬓露山骨鲈肥月华秋华涧松荷缺霜树梧桐雨金风老山骨瘦宋玉愁退溪毛陈王楼阁黄花冷落兰衰花白满城桑落酒秋随庭树老苇干云梦色霜清溪有蟹陶令藩篱红叶飕飗荷破叶青霸岸菊花天寒逐鴈声来橘熟洞庭香叶落木无蝉烟光藏落景芙蓉景江国山骨露高秋蟋蟀上城楼
秋夜::月白卷帘帆宿睡鹊宝炬江风秋色戍鼓风清欹枕杵鸣啼蛩银河野月漏声渔灯金茎月影虫声月落玉绳凉天秋晚河影宵残蚊雷天寒孤灯流萤碧月露华鹤唳星沉金柝清夜夜长月华梦觉蚌鼓夜静寒杵征鴈重露风吹叶行人寂萤自照巢鸟动青苔露风过鴈清风足梧桐夜愁夜雨稀星月上轩宿鴈幽鸟相呼露菊香黄叶风月移床残月明蟋蟀秋怯秋灯读书灯月上翠梧仙人掌冷疏疏列宿夜凉风动竹萤光连烛动露承金掌重裁衣剪风传银漏玉女窗虚耿耿银河人静月当楼月影带河流天压玉绳低云笼千户月几声敲竹雨木落桐应瘦风急万家砧一点读书灯宵寒漏正长
悲秋::偏感鬓老潘兴登楼月冷离思木落独悲衣单宋悲览镜风高幽怀林疏寂寞归鴈梦寒一灯登高萧瑟秋色晚景白发憎蟋蟀老无味风瑟瑟萧条征鸿泪尽双杵怀远凄凉夕阳归心秋情感蛜蝛秋最愁露漙漙荷叶雨家千里枫愁客怜瘦影旅馆凄怀饮露寒蝉杨柳渐稀潘安感兴高秋悲画扇荻花风天一方菊为谁动新愁西风摇落嘶风边马芙蓉已老宋玉悲愁久客掩柴扇气与千山壮长年临镜恨家远传书日心怀万古愁故国倚楼心秋来为客情
晚秋::归鸦霞红烟凝断红卷雨山紫日落晚照正枕宿鹭孤鹜画角过雁罢钓野烟沉秋月上孤城暮牛羊归径险野阔秋无际收书归樵落霞残阳归鸦吹笳平沙照夕禽还远水明鸟雀聚枝深天空夕始凉半树挂残月鹭飞秋雨冷斜阳明野屋千岩添白云虹饮晚川明寒气到征衣
冬::寒林冰合貂裘严霜讲武颛顼厉风霜日霜铺兽炭爱日赈寒玄冥寒景黄草介蛰雪飞岁寒风劲地肃更长木凋雪埋云容风响冰蚁霜蟹寒柯潜鳞冰结日短霜寒天凝昼短松秀云压雪意水澌寒鸦梅花麦肥冷凝梅荷尽老树云著地三农息砧声急风色急山容瘦地始降梅瘦寒结火兽菊残寒江雾填空万物成雁影深鸟声哀野色宽阳气潜经霜柏宵冻厚经簷日波声冷摅雪天黯淡云连海岱洌洌寒风播江上风翻赤照野梅晓霜严扫叶风霜气晨凌烟瘴苍忙霜闭园林凄凄爱日流庭前日带黄腊洒浮新绿阴凝风渺渺南国昼多雾斗杓方建北深山催短景寒梅折旧红江冷水漫漫北风天正寒日影觉回南乔木易高风
初冬::初寒阳月始冻孟冬获稻纳稼破柑讲武初寒书灯池冰山寒晓色冰骨木落冷云千林瘦纳禾涤场尝稻始冰始冻炉火簷雪水落寒声霜花水干红叶百室盈已摇落霜后水薰初暖斗杓建亥霜凋红叶密叶翻霜彩冻柳含风落碧瓦初寒外渐萧条晓来冰冻未坚日驭移房雨熟黄梁轻冰歛水容山花映日鲜金茎一气旁轻簷低短日霜苇多先折酒喜新??熟凝野惨寒云江花或后凋橙如故岁黄
冬夜::玉漏烛暗书灯鴈声寒月月华冻冰菊霜冷榻月暗金灯枫凋画角兔影远风梅影风帘梅月寒灯霜清庭阴霜瓦纸衾漏冻青灯风壁眠迟雪月缾笙一灯听雪火老冰柱折月影雪窗雪屋灯寒红火月窗吟苦霜风炭兽残梦围炉风微玉绳低梅影云淡薄鸳衾重风声冷灯焰冷霜初下更长睡少梅影横窗梅香入梦竹弄声月黄昏兽炭消月华高竹阴清月正高漏永寒多竹声到枕雪片敲窗倦鹊绕枝梅花天下白烛残偏有焰晓角催寒漏梅吐三更月竹风茅屋冷雨过书斋寂飞鸿摩月雪片夜深寒雪盛却无声孤灯旋落花松号一径风梅月纸窗明风穿竹户寒
苦寒::劲气地冻鹤语裂肤风霜密雪雪拥寒水凛冽帘寒水合冷面涸阴天寒鴈归堕指雪霰狂风冰凝顽云严凝瓦冻云垂冻髭北风冻雪雪积凛凛怀冰马猬重裘薰披重烟脱镫血冻冰生袖山中冻腊雪愁云冰凝棱棱呵冻水冰挟袖拥炉炽炭枯桑气寒冻切肌世上寒吹作雪毛皆猬千山雪辟寒犀坐熊席鸟失条冰生瘿愁冰砚水凝冰骨冻成冰手亦龟一尺冰却暑帘衣狐裘人坠指气吐虹苦胶杯风揽雪花妒雪双梅老厚冰无裂缝破窗灯焰走呵笔将成冻凌波一鸟闲短日有寒光冻砚笔锋迟鸣琴欲折弦
晚冬::曙色残角天曙日色孤嶂月披霜早寒光疏钟楼寒鸡声五更霜待漏迟星河淡长亭使客鴈鸣残月疏林落月残星同月落枯木鸦翻早窗蝇干易死鼓角悲紫禁朝臣钟破晓霜远巷残砧晓角带霜吹残星鴈过迟笼鹊冻无声绿蚁寒堪敌红鳞煖渐生卒岁短景雪霁霜重梅蕊厉风迎春寒宵春回草枯柳条朔雪野雪穷阴岁暮腊残风劲严凝寒梅岁寒岭梅腊月梅英绽日穷次坚冰履江梅短影星回春近云浓凛冽腊酒春信岩柳寒崖柳眼封星回天出土牛坚冰冷池冰合残腊去梅破腊山色淡岁穷风力急烧尽峰峦出看雪何妨醉乱雪飞岳雪明早春回柳先春水声低江阔鴈声寒霜晴木叶飞寻春即有期风兼残雪起河带断泉流
闰::岁余三年余分授时月余居门月困奇数前寝古周正有朔五岁积算作纪岁编朝庙日穷积分左扉纪鲁终斗指两辰尧以有时告朔严书左气薰灰管验月桂亏还正六旬如可借分积余日鲁不告朔厘工谨命羲数扐卦辞推阶冥落复滋四序应如期
丰年::岁居斗覆有秋时和余粮崇墉年丰一雨至治臻无事火退西成日红鲜终有日散为百姓食稔岁岁熟多黍高廪食足三登丰年落有成金穰大有年玉粒未曾悭堆作九年储圣德应多稔皇家配有年
凶年::荐饥乞籴荒政发食输粟菜色竹实乞籴来邻国数奇逢恶岁屡歉劝分拯民饩粟泛舟鹄形凫茈分忧累故人计拙集枯梧
立春::春幡彩燕土牛饯寒木德葭飞腊酒迎暖生菜葭琯初阳斗巧彩胜椒觞春蝶迎气条风花胜辛盘逗寒剪旛果盘残雪迎春一气泥牛缕银栽红青帝红叶春头胜三阳至迎水德回木色金花胜三阳钗燕剪彩晕碧东君青杨腊尾杯万物新表农祥满梅梢柏酒杯留腊雪钗头燕斗建寅史官谒风渐暖示早晚农祥正竹管飞葭满谷和风醉春风陌上牛物交泰天子迎日初暄歌青阳斗柄东玉盘呈果半窗晴日风消积雪女工翻巧宫花插帽日影飞花殿有蛰皆思旧江山新气象池上莺声早月动游尘农事催耕园甲堆盘风纹积麋池无荄不欲萌草木旧精神风前草色初风光随处好细风先动柳木梢寒未觉景色一翻新残雪不藏梅地脉暖先知寒尽送腊腊酒残岁腊尽暖回迎春春盘新年春来新阳旧岁一日送故将终日消旧酒一夜腊一岁将终岁尽今朝物以终为始早岁新春两年迎新启始时对春风两年春三春启始春回此日人从故得新迎阳朝剪彩酒醒笔花老犹残一日腊守岁夜倾银诗成草梦新并见两年春物始辛盘献岁彩燕春至春头柏叶迎春土牛阳生新阳初阳三元首斟柏酒蓝尾酒斗杓易位金杯浮柏酒画鸡岁日端月初临候首岁新岁一岁初献椒觞蓼芽饧阳律飞灰玉管动葭灰彩燕表年春新阳已届辰柏酒和菽酒缀条花剪彩未肯欺残雪辛盘与菜盘插户柳生烟何当占旧年
元日::四始三朝元日爆竹苇索湔裳三元五辛春王屠苏松枝藏帚献鹊飞凫火树正始鬼丸柏酒花灯新阳新历朔旦献岁开元岁首放鸠翔鹄灵花履端仙木椒觞金胜首祚初阳元正祭春正旦春初称觞祈谷椒枝柏叶酒德新在木人间迎岁改南陌祥光紫松应添岁寿火官陈禹玉贺寿设经柏叶五辛盘斗建回寅天上应星回东郊瑞霭青梅尚隔年花司历贡尧蓂人心新岁月花落梅心老春意旧乾坤草青麦意新
人日::董俗剪彩灵辰荆俗贴帐行乐菜羹戴花陈仪缕金新岁晋风搥林作缘花胜剪饼三阳晴更好桃菜嫩验尧蓂金作胜风随律吕樽前柏叶花簪王母柳条弄色七日健尤佳缕金新占夏历彩为人树占阴晴胜金花梅点寿阳梅花满枝楚人新饮爵桃色看犹浅残梅诗兴晚水生桃菜渚花风才一信碧菜羹新煮雪消生菜甲魏氏旧铭山梅花落已频细草梦魂春烟湿落花村人日故多阴金花胜巧裁风暖断冰澌
上元::灯市火树插柳银花九华千炬鹤燄踏歌火蛾花衢宝马神灯星桥灯楼传柑珠树七宝百枝龙灯望月面玺酒市香车佛火游子家家罗绮灯火莲烛冠盖千门月影风烛翠袖月光宝车火城佳人处处管弦笙歌星灯轮蹄九陌灯光鼇山坛车灯焰银烛花市竹歌长春国笙歌千点火灯万盏春富贵纱笼擎烛金吾弛禁鼓钟喧夜柱舞不夜天锦绣中一天星月千家夜风流银鼎烧香玉漏莫催罗绮满阶一天星斗倾城游宝马九陌连灯影穿花丝管急关河中外异屏展挥云母樯炬疑龙现万井笙箫匝路转香车千门共月华踏月马蹄轻灯火上元同帘垂晃水精桥星讶鹤成
雨::阴寒云生云妒密洒无锦绣此生此夜闭门微雨夕里巷稀灯火寂寞雨阻雨昏乱飘少笙歌行雨行云远笛落梅风亭台寂管弦已无鞭石术谩云妨赏玩空有看灯桥谁识润焦枯
雪::六出嫩冷看灯失意罗绮少千里玉万家轻寒飞雪妨游管弦清一城春压银花似妨游子雪深推响屐独喜开金锁彤云藏月窟成鸾袖舞玉树如阻佳人风急更吹灯俄惊糁玉尘绛雪锁星桥化作兔园游
社日::报功反始后土结宗卜昼鼓吹夏松释奠封土松榆停针赛田簠簋主阴洛水勾龙设壝农桑治聋商柏祈农方坛松柏击鼓卜稼幢幡报本香山日暖村醪桥下割少村落鸡豚家家酌鸿尽去赛田鼓丁家社寻巢燕风和社肉坛边分均岁时箫鼓处处歌燕初来祀肉鸦二月天唤雨鸠吹筒搥鼓南亩田功作灵祇依古树枫林社日鼓万里开耕稼高梁新有燕圣主虞忘本宰肉分杯东部社酒香醉叟倚村童茅屋午时鸡三时顺雨风细柳早闻莺农民重报恩
祭祀::元巳袚沴东堂剑捧油花木兔兰亭曝药石坛绛枣列爵踏青上除招魂南涧觞随薤露钱龙蕙亩弹琴金堰青柯陈肴赐柳濯秽蚕市华林东亩流杯时泰山阴握兰回流祇社晋谷谷中修褉蠲疴羽觞疏闸西林曲水气明洛邑袚褉褉饮赋诗洛滨水面舞雩浴沂桃花浪华林赋和风暖日采和胜事韶光三月好曲水传佳咏袚除周典礼褉洛竹叶杯曲水诗野草闲花工部高吟褉事一时修崇山记胜游觞咏晋风流水引春心荡人去伤陈迹鸦丛桑椹紫花牵醉眼迷春深忆旧游蝶冗菜花黄
寒食::禁烟焚火画鸭歌吹绣陌绮罗熟食藏烟斗鸡拜扫香车车马彩索紫陌美景芳草拜墓厨烟疾风花舆秋千传烛麦饭宿草纸钱红毬芳衢良辰垂杨出城燧火冷雨蓝酒蹴踘飞花榆烟新坟饧粥榆钱红杏上冢澄火雨红粉女蓝尾酒花怕雨山杏雨芳草地烟初冷逢寒食杏粥绿杨凭高养花天绿衣郎蓼芽饧柳依人海棠风杏花天火自寒叫杜鹃桃千树名园曲水杜宇声中远巷踏歌野树啼鸦榆柳迎新火留饧和冷粥紫陌留香毂雨一犁暖日和风棠梨花下隔吹管颓垣荒蔓龙蛇隐旧烟出火煮新茶芳尘扑秀衣草绿唯供眼松柏卬山路厨冷烟初禁花红只笑人风花白帝城榆寒火自新岭外戍楼客情异香觅路途中江浦归梦故国怀乡临高桃李无家马上穷途路故乡有梦别地看花归心飞鸟外无家对寒食洒泪关山有梦途中杜宇声新火伤心异乡闻乐乡泪落花前有泪仰金波飘泊梨花雨故国邱坟在追随杏叶风他乡祭祀同
雨::客愁禁火花色花惨红杏曲寒食雨妨拜墓魂断妨游云际人愁绿杨深花信风阻游人滋榆荚无车马连朝雨闲蹴踘侵阶草色桃火湿不灭烟湿秋千索阴云花减色湿纸钱绝管弦昨夜风锁秋千满地梨花柳烟滋更深泥壅蹴踘场春日水还东不见红毬出谩有杯盘客那论彩索飞应无拜扫人
清明::改大桐华进火新火茶乳走狗风光留饧试衣榆火新烟温风烛饧啼鹃月色钻火冷粥冷灶紫燕莺声柳眠柳花紫陌浅草百花淡烟调马地饧粥冷莺自语新茶春城黄鹂游子花落榆荚绿杨淡云万卉微雨养花天腊烟新雨初晴梨花雨花如火莺斗巧莺舌巧梨淡白榆柳火龙蛇蛰人歌人哭秋千呈巧柳絮风柳似烟蝶飞忙燕身轻柳深青梧桐花草木柔花落花开蹴踘争嬴景舖诗句烟和淡翠梨花淡淡雁归紫塞榆烟杏仁惊花春正暖燧火开新焰红杏难藏火人在醉乡风卷残花野草青青火钻青枫柳絮梨花车马雨初晴桐花发故枝垂杨不禁烟清歌邀落日白鸟窥渔网日暖输蹄路妙舞向春风青帘认酒家风翻锦绣尘
立夏::修景犹和春归丹鸟火德麦秋长天渐热暑至薰风南郊梅雨葵日芍药梅黄薄暑春渐去杓向巳莺犹在日催酷热薰生殿阁老却流莺槐风樱桃麦熟闲天日初长风已南葵又开气尚清和斗指东南新闻蝼蝈炎帝执衡东君休布令风光初变换郊原浮麦气中吕星杓转律转薰风始蝶恨三春别祝融司节赤帝已当权天气尚清和池沼发荷英南郊彩仗新杓回火德新花惊一夜空律旋梅雨候气润麦秋天
端午::浴兰宝篆结庐竞渡赤符天中九糉角黍采艾虎艾斗草灵符采药辟邪朱索地腊五丝香蒲蓄兰龙舟龙镜烹鹜菰叶筒糉穴枕赐衣蒲觞泛舟令节兰汤踏草尧樽茧彩枭羹贡枭稻花粉团御珠系缕艾糉系臂佳辰艾酒佩符楚糉珠囊长命缕行快马斗百草系彩线黍包金千古事延寿酒一天梅雨羽客传符赤灵符挂艾人缠五丝夺锦标壶泛五一时情辟邪香千里楚江仙翁采药三年艾叶丝缠玉臂五蓂开瑞荚蓂草开金带遥怜壮夫臂身随彩丝系艾叶成人后九节菖蒲符插云鬓百草开香茗榴花绽绛裳也系女儿丝心与绿蒲清榴花结子初细葛含风软鱼腹灵何在村远孤烟迥香萝叠雪轻龙舟曲谩喧溪昏竞渡迟
伏天::亢阳老火骄阳火炎六月火升金藏俱署黍金畏景金伏三爽炎炽火盛畏暑泛舟赐冰煮茗避暑荐瓜汤饼磔狗烦溽汉泽闲窗紫李乌纱伏阴挥箑摇扇劳酒寻凉赐肉麦瓜炮羔赫曦秦祠小簟黄瓜白葛赐羹锦凉棚夏秋交村落美怀归肉苔花雨润六尺簟舖奏祠御火金行不胜火割肉碧筩酒金火伏道衣凉避暑杯薤叶风凉一时扇握河溯会饮夏令已交秋乾坤方火盛人间多苦热清谈停玉麈进饼随荆俗宇宙觉金藏天上没微云雅曲弄金徽炮羔忆汉人
立秋::暑退白云白帝露下凉生金茎蓐收风高灏气鹰击叶落西部草衰玉露乘帨三伏尽金茎露吟暮景商声劲火威退凉风?刘火流金德莲谢金风竖竿一叶凋玉宇风赋秋声爽气高凉风生风初起暑威淡燕除巢荷淅沥闻急竹荷翻雨莎根蟋蟀江山改色蚊亡虫枕歇露已浓天气清鸿出塞月微茫厌纤罗燕引雏棱稗蜻蜓草木催容雕鸮天高玉律鸣秋秋风生桂半廊月白安仁感兴今宵露白西风树老塞外孤鸿入西风蝉已老金风荡暑夜露栖林一叶桐飞宋玉悲秋此日风凉夜月凉深枝头一叶飞夜月燕将稀金气晶天宇律转商初应霜信初传鴈秋光凝翠岭商声战海银天高火不流风声已报蛩凉意起梧桐
七夕::鹊桥乞巧彩柳蛛丝鹤驾晒书金校宝玉羽车云軿穿针金风良夜灵迹织女珍果星河赤龙新思驾河香帐云辇玉佩整线玉露佳期瑞光牵牛杯盘云汉青乌旧愁渡汉金针粉席银河天孙星桥神光玉匣汉渚灵匹浮蜡映月七宝枕九微火长生殿香筵星渚河鼓月烛赤气华筵云川天媛陈瓜凌云九华灯百子楼百子池支矶石回文缕秋驻辇陈瓜果骈鹊宇经年别穿针女蛛丝巧百子池花金风入树犯斗槎乞巧丝晚停梭拂绮罗驾牛车五鼓催对酒人凤幄仙五云楼月银汉横空碧落银河天上佳期牛渚联星轮随皎日风清露白蛛丝结网清风袅袅天上秋期近金风玉露人间令节鹊桥横汉桥映疏云月淡星明鹊羽成桥薄雾纷纷人间月影新凤律惊秋气鹊辞穿线月云归天上客欢期唯一夕巧意世争乞庭铺阮氏锦龙梭静夜机花入曝衣楼巧赠世间人别恨动经年神光谁见通腹晒郝生书
雨::乞巧岑寂月暗天路泪雨泪痕入夜藏明月百子池平嘉会添浓兴添愁萧条云迷彩楼愁云别恨通宵锁暮云五云楼暗清游减醉徒雨暗千门月欲阻填河鹊雨云连夜起云迷百子楼先兴触石云牛女隔年愁
中元::良辰蜂出校籍设斋桂华礼佛庆月螘行献果稻熟思亲严祭祀供大德风光爽将圆夜地官降大醮玄都竖幡供佛月色满身云迎碧落外敬追修奉高真气象清正早秋孟兰供泛舟赤璧制芰为衣秋声入耳章奏玉皇宫暗虫依露草银河低案户坛滴槐花露惊鹊遶风枝玉露稍沾衣香飘柏子风
中秋::〔与天文类秋月参看〕至晚弦管文晏香屏袁宏渚通宵杯盘仙槎歌扇庾亮楼风侵鬓露和玉屑彩幄神君转篷行地远一年逢好夜微云消碧落中分九秋夜冷透肌月射珠光琼台仙女扳桂仰天高万里见清时湛露泻金茎占断一年明风生惊叶坠露重觉荷倾
重阳::三秋年年陈迹佳节龙沙习射插萸食饵紫茱狂歌九日处处旧游重阳凤岭谈经采菊题糕黄菊痛饮画堂落帽衣裌菊酒授药把酒酩酊木落江枫插菊龙山金菊渊明赋金盏浮杯登高茱囊簪花佩萸登临天寒篱菊看萸蓝水银觥子美诗乌帽落秋已老紫萸佩骚人兴玄猿哭乌纱帽今夕醉授衣月败叶飞白衣来碧萸香日将沉黄叶飞陶令家白鹤来绿蚁杯一时情落帽辰寅花吐乌帽落菊花期红叶黄花一声云雁黄金花伴汉武横汾花香泛泛紫萸插鬓登高逢九日桑落酒白衣绿蚁几朵霜花红叶树间刘公戏马客醉纷纷细菊浮觞吹帽任斜风篱根菊始绽宫女佩茱日日晚鸦争宿野色生新黍同醉菊花酒尽喜登高宴瓮面酒新??参军落帽时天寒鴈叫霜秋声入暮钟缓掉木兰舟谁为落帽郎冷落带酒冷雨菊悴滴树云淡淡泥拍肚寻箬笠花空落妨蹑屐荒凉悲吟凄风兰摧平池雨凄凄水平脐觅蓑衣水逆流怕登台西风酒旗市感事悲双鬓雨冷侵灯晕客减登高兴秋声连迥野细雨菊花天消愁酒一杯风愁送叶声人闲烂醉欢溟色入高斋佳节异乡暮岁萍梗转蓬他席愁里醉秋光好九日清樽孤馆萧条抚景有诗心醉愁边酒思乡菊花采菊故园客中贫晚节香十年为客落枫点缀开怀无酒身归梦里家却因今日菊黄花又重九江枫徒自落还忆故园花白发尚他乡篱菊为谁开
立冬::小春地冻水德黄云闭蛰祁地阳月水冰霜威丹鸟始裘迎寒玄冥北陆习射破柑祈年青灯雀化燋糟暖炉回暖池冰上冬除气结青女应钟涤场尝稻讲武炉火虹藏黍膳饮酒惊寒簷雪良月羽音调杀羔羊玄冥令西陆饯山露骨貂裘白斗杓建亥白帝停西旆秋谢三更雨寒蹊径青女霜北郊迎水生皮兽炭红日驭移房元冥接北郊寒随一夜风北户移扉日山川形悴色叶尽千山瘦南郊向帝时草木带愁容霜严百草干
长至::宝鼎迎长新阳阴极阴伏献履黄钟来复亚岁阳生阳升吹葭短晷望气昼短寒威书云管灰鲁台寝兵赤豆八能开荔占赦豆麋微阳迎寒宵长春信量日官线尧历调历绛衣三义放梅断囚云物梅花缇室履表绝事一阳生添弱线灰已动视日晷红线初添鲁观占祥芸草葭灰袜铭宁身群阴伏动浮灰晷初长占丰年黄钟乍转周家视祲梅传春信一阳来复日行北陆天根转处金堤催柳应律三阳首天心半夜子角弄寒声万物始生春到南枝宫线添时仙苑破梅朝天万国同道脉一分阳八荒开寿域星见方腾昴无酒味方淡候晓从缇室喜动儿童色一气转洪钓阴穷始动阳太音声正稀迎长验绣文欢传父老声
除夜::迎新击鼓爆竹行傩岁别列炬餽岁烧灯屠苏分岁春回奠盘惜旧梅素终年共坐今夕闲语饮酒岁尽杯盘守岁岁华送米列炉迎新烛红残腊孤灯明年不眠藏钩星回灯烛迎春人事开筵听角寒灯更阑椒花烧爆竹一年尽人欣明日寒杯送尽坐消残腊今宵光景旧岁鼓腊尽柏酒写桃符四季终我恨今宵曙角吹回伫待明年来日岁时新古今因此尽不辞加一岁酒泛山杯绿腊带吟愁去残灯和腊尽闺人裁柏叶新旧逐时分惟喜到三春梅开水国红春随笑面回晓角带春来雅子画桃枝清祀劳农嘉平纵吏迎气持椒祠彘清曲索飨画虎薰肉始福小岁鸣鼓祭啬祭兽晨吹报功赐药磔鸡银罂和幽迎猫藏板卫凶升朝磔鸡移民荐禽冬酿梅破祀灶祀五祖禾归窖商人典银铛捧药猎兽逢良旦梅腮传腊信劳民休庶务柳舒司神祭百神酒满杯夏氏仪素手簪幡吹豳属介辰柳眼漏春光报蜡享群神乾坤催短鬓宴礼非迎气劳农追旧礼风雪薄空山司神为报功纵吏踵前规
守岁::守夜绿蚁隋客三鼓候沉香燎轰鸣竹嗟岁暮殽具送迎围炉不寐寒辞去冬雪驱傩红炉楚俗五更钟爆竹声听颂椒喜天开桃符更代爆竹惊眠暖带入春风迎春朝剪彩不眠须待旦共饮屠苏酒斟酌分岁酒守岁夜颁银痛饮共迎春频传琥珀杯熨贴拜年衣
土地::物生邱陵荒极积阴广大四游五土积块养材藏主泥沙流丹常静母德经纬纮埏湛浊刚柔七表九州成形敏树天根郊野濯锦以宁充塞潢络壶公索群生载载物功非浅绵亘三千界江山形不改断鼇何处立化醇绝维蒙谷游万物亲无私德莫穷纵横百二州草木色如新驭骥几年巡竖亥尤难遍大章未易窥
山::崱屴山截山辟刻削嵂崒奕奕岌岌兴雨云藏碧岫峭壁远岫巃嵷崚嶒嵯峨崔巍巍巍苍苍出云霞映青岩悬崖崇巅霞璧叠嶂溢银生物采药送青螺髻翠黛点翠鼇烛卧龙卷石排戟翠微层峦出玉调神携诗耸翠青鬣画屏涌螺莲崖回鴈纤尘列屏入画松门蔽日形高洞天神阙豹隐玉笋千峰光分万重不让青壁供诗石磴千霄势耸神府仙宫猿惊瑶台寸碧势展千仞结成玉屏峭拔堆螺列岫隐居杰立崄岌一拳石巨鼇戴草木茂楚霸拔寻石径三千仞巉岩拥翠危巅樵径横开峥嵘三神山愚公移禽兽居秦皇驱入松阴十二峰千峰翠日映岚光灵运著展谢傅栖迟龙头突出铜陵映碧涧白云横不度未知真是岳万仞青雨收黛色郤诜停骖羊公感慨鼇足断来石磴泻红泉高鸟倦犹飞只见半为云竹树来今古古壁丹青色始从拳石大任使千重险丹青半有无新花绮绣纹终致极天高何如一向平采药碧纱犬吠烟霞瑶草持杯丹灶鸡鸣日月仙桃势支五岳碧沙洞流水桃花洞桃初熟路邃云封密石洞烟霞古桃花今尚在流出一杯红树枝头玉沙瑶草人间日易斜山高日出迟仙桃雨露香仙子昔何之
水::润下朝宗包天春满静鉴四渎荥河四海益深流湿负舟鱼鳞鴈浮浮天绿波带地冬凝怀珠三江入海百川就下积阴利物鸭头鱼乐载地清浪满泽穿沙渺渺悠悠冯夷习坎物水无滞漾漾匝岸碧潮拍岸激石兼天倒峡溶溶滚滚河伯盈科锦流有声滔滔平堤绿涨平津扬波水色桥畔秋浦金清春深一勺多流百川平中准方圆析通诸海清到底潮光柳边暮潮鸭绿秋涸万物润利万物负大舟清浊音观其澜碧连空浮青荇清见底流不尽玉方流百川合派窃壤以堙动乐有机日暖寒鸥浴醮绿杨绿生波意自闲珠圆折万折朝东积灰而止虚浮无物人归小艇横苇岸漂红叶漾日青浮鸭既为朝海势可洗许由耳风蹙波纹皱净与澄心等渔矶侵绿苔含风翠蹙鳞复起履舟波能浮范蠡舟烟含练色新清将照胆同
水声::骇浪鸣湍鸣弦鲸吞石激喧豗水乐浩浩浩渺昼夜惊涛触石漱玉鼍吼山回震掉籁鸣泠泠潺潺古今惊浪雨后摘月危湍喧玉韵来客枕朝江汉闹同风撼竹怒湍号不彻可乱笙簧韵怒湍风前穿云险濑杂松声响山居动鼓鼙清等夜鸣弦触石激难收能分风雨声
水帘::云额玉碎飞带喷玉悬空一条喷云直下入画一竿高挂滴滴月钩珠联挂蟾飞珠挂壁千尺遮月常流飞空万点长悬潺潺云际新月奔泉映明月展开百尺飞流垂洞口额借浮云卷日看波浩漾巧障华山女岭头垂虹走石碎白云隔断长空一派挂簷头钩凭新月悬夜听水潺湲轻遮姑射仙
冰::北鼠东蚕煮茗三冬朝飧瓶中狐行凝阴出壑坚凝水冻冬凝棱层夏荐渡狐渡河六尺夕饮壶里鱼负履薄流澌涸沍泽坚春泮皎洁冬藏跃鲤积雪寒气玉壶堆琼皑皑作花珠碎气聚春鱼上洌洌凝阴至夕饮臣钦命履霜素光月窟沍玉叠叠澄月星流藏周夏虫凝峨峨积水成春开帝荐诚一川寒浸玉照人光洞彻莹閟江心月月浸光如莹万壑冷浮银何日色澄明光遮水底天风号冷已凝
江::岷源荆池四渎萍实鹦州楚望震泽六川菱花鹊岸祭胥沉书九派潮海浴日转山茫茫洪涛澄练观涛击楫菱花朝宗吊屈投局两川兼天浮天平岸滚滚巨浪滥觞扬水乘舻兰泽权概蓼穗云鸿荆渚滟濑中郎浦限南北激赤岸归渔浦鹦鹉洲前谢眺波澄芦花雾鹭楚汀沧浪使君滩辨东西发黄苓入海门鹧鸪山下伍员涛怒云沉风荡浪叠千层白九江春草外设险浑无地晓泛吴门月潺潺清到底近濑湓城曲浪骇波驰波翻万里青三峡暮帆前扶危赖有天秋涵楚岸霜浩浩碧连空斜吹蠡泽隈地留孤屿小天入五湖深
竹溪::霭霭渭川清声送月波青小桥涓涓淇澳爽气吟风沙碧细石戛玉傲雪漱玉袪暑风声无暑气一泓碧玉碧玉波涛冷月影飞丹凤穿沙碧干静摇琼凌波敲金浴尘波影有秋声两岸清风苍龙窟宅深雷声濯锦鳞落水紫包香荒笋侵颓岸寒梢拂小舟
竹::白色脉脉猗猗穿云清流寒色细溜碎影涤暑蠲慝影碎纵横迷野迳翠阴泠泠湛湛带月寒影细声柔梢细流攘寒生凉声寒淅沥下莲塘中含青不见避日波尤冷波漾苍龙动枝疏沉月影界破浓阴密浮叶翩翻过傍映碧相连穿云脉更长声和彩凤鸣停溜湛波光分开细脉长穿云屈曲流
井::绮栏石甃玉槛银床玉甃桐生投辖玉羊丹砂泓寒寒泉美水掘地凿饮桐阴金瓶金干银罂桃落润田金鸟云母甃碧清液清泉及泉破圆苔色泓澄苔侵澄彻百尺深黄帝穿苔藓色炊香稻桐碎影雕镂为盘体清能鉴物冷冽月透寒甘千丈润尧民凿辘轳声煮新茶桃落花宝钿作干色白每含虚深涵秋雨冷团团围石甃通为今古惠旱许邻人汲及见嬴瓶者静泛落花香耿耿荫桐阴用济往来行湿余秋草生翻思抱瓮人
池::积翠止水清泉凿苔通泉春草凿地铺锦养鱼叠石园内蒲长波光鱼吹絮坠絮浮萍朝涵旭日寒光一片石偷天刻鲸洗砚流泉亭前萍生日影鹭触萍惊鱼避鹭夜浸寒星碧甃四隅新夜待蟾光入白鹭窥鱼立滴月韵如瑟冰壶新莹绿朝观水气清红鳞逐藻游涨萍波胜苔宝鉴乍澄光
山水::绿绕峨嵋秀青罗带碧螺髻罗带水来青来燕尾分碧玉簪苍玉鳞剑芒山起千岩竞秀好山千嶂隘鸟度屏风山势蜂腰断乱峰巉似槊山如翠浪涌万壑争流流水一张琴人行明镜中溪流燕尾分一水淡如油水作玉纹飞
石洞::瑶草碧沙日月玉沙红杏烟霞翠藓白云野桃云壑猿啸野人笙歌虚室藕花水面青儿守菱茨实碧桃红叶寒溜石坛龙归仙子云鹤高窗松影山腰白云封薜萝衣连溪碧秋深青藓匝门开空寂寂翠滴半空雨石泉为晓镜雨腥龙起处满涧香夜静白云深地僻暗沉沉苍摇一壑烟水月当帘钩云伴鹤归时
石::苔缠土精云抱地骨落星印鹊奇形磊落苍藤萤过采处一拳云根苍苔色孤云绕添幽致化女井龟怪状巉岩碧藓蚁穿断时双笋海眼瘦鹤姿万木姿助雅吟熊渠射虎烟波含宿润带山疑似兽微醉还堪倚雪尽身还瘦奇应潜鬼怪尖削琅玗笋初平叱羊苔藓助新青浸浪有如鲸孤吟静更眠云生势不孤灵合蓄风雷洼剜玛瑙罍岩姿春藓匝潮色白云随
竹径::清风漏月爽气无尘幽寂倚杖醉魂碧叶环合碎影淡荡叶疏扫月拂云碎月一迳声萧索萧条弹琴诗思绿阴森罗寒声扶疏阴足引风夹道清音数竿影交加风淡荡风声碎疏镂月王猷笑咏夹道舖清荫此君浑不俗中含清不断绿影连花圃月团圞日影斜曲通村蒋诩行吟沿蹊锁绿云佳客足相留旁合碧相迎清荫接酒家拂石风生尘穿篱阴屈曲支笻露湿衣遍路影交加
石桥::玉甃飞甃金柱霓拖金堤截川玉栏虹饮鞭石势曲苔痕百尺江声侵汉崔嵬半边月脚底江涛造舟浮渭日枕溪鳌背阔飞空如磴浪影千年石角压波突兀十文霓望中烟屿鞭石表秦功表柱鹤翎高何须金作柱不畏洪波急自有连云势不假玉为栏全凭数尺横何劳架木功
市井::街衢嚣尘旗亭一哄懋迁货财通通万货聚四民青篛裹蓝财货通天下阛阓廛肆候馆千家交易车马闹会三时驱百役绿荷包饭锥刀较日中财货交通地书有王充阅康衢游客闹晓郭云藏市舟车凑集时箫无伍子吹闾巷隐人闲春山鸟护林
城::新岸玄菟百雉崇中粉蝶九重金墉巨防固国临水鼓角保障女长云芙蓉千年坚垒黄云万里铁瓮要津守民依山楼台浚隍雉堞不假贤侯杆月落千家晓封疆资保障万里秦基固飞云霭层阙宁忧哲妇倾霜凝百雉寒社稷愿经营千年汉垒坚白日丽南隅
京城::神州作丰赤县营洛九重阆苑神京帝宅京师皇州御沟龙蟠金殿北极禁路轻烟天威远万雉女天府王城都会帝里辇路虎踞玉楼中州名园佳气国势尊帝王州山河壮尧封禹甸金马衣冠百蛮入贡天垂华盖近地即帝王宅楼台万国合形胜地观阁雄汉苑唐都铜驼箫鼓四海朝元月转紫垣来山为龙虎盘车马九街通绝域梯航至礼乐新王化云开双阙丽遐方玉帛盈山川旧版图柳映九衢新
江城::气蒸水国连云楼台拍岸江月波撼江楼近水波浪遶城风烟沙鸟天光含细雨谢眺诗中水声驰万马碧波光掩映楚设关城险绿涨他山雨江花波色卷平沙夫差传桥影跃双虹粉蝶晓峥嵘吴吞水府宽青浮近市烟鳞依渔户舍地控吴襟带驿道青枫外绮错稻田沟才先汉缙绅人烟绿屿间
山城::千里奇峰林峦连峰城门鸦噪九重粉堞城郭接汉烟磴人归楼台萋萋草带埋没秦台苍崖红壁城僻门开晚巢云连粉堞风雨悬秋夜处处青烟起松柏爝爝苔封荒凉汉垒古堞空壕山高日下迟积雪峙银山云烟锁暮天家家白酒香市小随鸦散人归被酒行
宫阙::曜华瑞霭金阙重门殿开旗常青琼丹楹万户帝里养德祥烟玉阶深院帘卷环佩彤墀刻拱千门皇州龙楼宣室虎踞玉墀剑佩仙仗上苑长乐四宝五演太乙思子离宫凤阙宸居龙蟠御炉衣冠宝舆大明太宁五柞六星长杨望仙别馆扶荔九重禁尧黄屋色媚青门内池塘春草路旌旗暗闾阖闾阖开黄道听钟出长乐阑池十二楼舜严廊光摇紫陌头楼阁暮云成歌吹满昭阳衣冠拜紫宸传鼓到新昌上林荣古树太液泛新流
故宫::黍离坏瓦野鹿断砖古殿何代落花腐草凋残空城麦秀颓垣宫莺残础荒城前王啼鸟垂杨颓朽古树草蔓绮罗尽花寂寞佳气歇春寂寂香辇绝铜驼荆棘树留黄叶秦苑有花香销管弦哀柳参差故台空雨斑斑草烟深辇路荒凉碑长绿苔汉陵无主江山九秋后古殿吴花草辇路沉江暗行人问宫阙风月六朝余深宫晋绮罗宫朝野草香耕者得珠玑
殿::宣政九华景福麒麟枫宸廷英百福延休鳷鹊蔬圃柏梁金殿仙掌羯鼓玉宇玉勒紫禁玉堂玉辇帝里壮丽龙楼轮奂风陛玉除玉炉凤箫彤庭金牌清都铜柱珠帘皇州峥嵘凤阁灵光朱雀翡翠帘凤凰楼星初落宫漏尽黄金榜九重日月山河扶绣户翠瓦鸳鸯折黄龙鸳鸯瓦鳷鹊观路未干御香高赤羽旗百辟衣冠日月近雕梁珠帘翡翠垂炉烟漆柳重晓日明龙阁太液天为水不寝听金钥宫漏出花迟春风满凤城蓬莱雪作山因风想玉珂
阁::校书石渠结绮危栏皓月藜火天禄招灵杰栋清风临流高栋雄投赏玩弥漫作序飞陛歌舞星辰近凤凰巢回环翠珠帘卷瞰道重簷范隐登临峥嵘招贤重阶画图宇宙宽麒麟画表青画阁悲阑干曲满怀风月簷卷清风逗修竹藏朱户湖山无限好凭阑生逸与枕簟闲一目江山窗开皓月过垂杨拥翠簷风月有余情灭迹远人群
水阁::江渚滩头碧浪光映翠色轩槛浪影曲岸贪看水清可掬吹酷暑白鸟长浮仰观天汉清流影涵浮光波涛波光映池怕遮山冷无痕涤尘襟红尘不到俯视波涛吟眸广阔簷驻彩云数杵秋声皓月中流见簷影随波动隐几对寒碧簷楹澄碧浪诗思沉浮江迷芳草一帆暝色清风四面来栏杆照水横当窗俯浅清轩槛枕清流
山阁::凿石小桥幽簷草迳跨壑轩槛猿吟依草当面月云扉冷竹树来今古凌虚危槛野迳幽簷凌霄松杉鸟噪近林四簷风石磴危丹青半有无地险人难至窗列远峰翠山远莺藏谷簷虚月早来砌临芳草烟簷虚燕垒巢
楼::盘龙飞翼挂玉紫云迎仙四户登临仪凤凌云栖霞黄鹤望气八窗眺望画栋摘星危阑耸汉凌空杰槛阑干涤暑卷帘河山夜饮接云夜月朱阑望月杰栋倚天迎日层梯枕簟止尘倚槛形胜秋吟映日秋风百尺梯峻增逸兴添诗料北极近百区水纳佳月王作赋凌云耸风清玉簟半空帘疏助吟情归画图南山齐四面山纵行云庾清谈映斗横月映朱帘望中烟水日月光先到阑倚无穷景有客方乘月手折月中桂树影春城绿槛外云山山川势尽来梯横不尽秋何人与摘星语惊天上人山明雪野晴百尺塞上孤城旌旗故垒隐隐吹笳枕戈危阑娑勒渡明月夜筹笔驿数层云边落日刁斗空城亭亭倚剑吹角曲槛受降城白云天勒铭山鸣秋草永夜角声壁垒依寒草倚槛闻刁斗战士思家处战马穷年汗孤城旗闭日起暮云中天月色旌旗动夕阳临风认旆旌征人堕泪边胡沙六月寒荒垒笛悲风落日三边暮寒烟一望平
江楼::水色潮声岸边临岸避暑耸汉琴书润阑干曲云涛动素练千寻四壁烟波云连海气楼上瞰流纳凉临流枕簟凉野渡头物色陈青罗一带上千霄汉风带潮声光摇青雀舫百尺齐霄汉水映高低瓦谁邀谪仙到波光明额篆影落白鸥洲千寻起浪花帘辉上下钩尚见酒星悬柳色上帘钩
酒楼::纵酒酒帘倚阑朱槛街巷会客醉语笙歌歌声宴饮独上百尺玉榼游人增酣思乐声沸市廛招宾酣歌鼓吹乐韵登临满斟一樽金壶醉客豁醉眸酒量宽懽情快朱箔迎风情浓惟春酒酣醺在云际一簇笙歌市青帘拂阑角画栋登天峻醉步危青帘映日脚倦怯登楼笑语乐人间半空灯月明朱箔上帘钩清樽得月光
亭::面面短长嵯峨种竹豁达茅舍柯亭折柳江山凉月花卉劳劳高下深邃栽松清凉兰亭竹室绝尘松竹澄泉松风云山卷帘小迳飞梦潇洒四围阶砌避暑临湖凿石竹动嫩柳朱阑风竹开牖虚簷留题清虚一望阑楹看书近路开池松移修筠石径玉阶碧瓦山月物华栽竹一轩浮云风树临大麓来醉眼柳逢春色五株柳下藻井朱帘水声诗思种莎四面映日池萍暗长春入吟魂莲弄秋香万里桥边花木红盈槛芳草和烟种山远秋泉白绿树为佳客月透松窗爽松摇千尺雨楼台翠拂簷修篁带雨移溪寒晚照红红蕉当美人风生石迳凉竹撼一窗风邮亭传舍野花行行马蹄垂泪驲传离亭宫柳送送酒盏著鞭柳外缆辔红袖把手别意人语往来人愁别泪留行客黄尘长短驿孤灯然客梦阶前销魂雕鞍分袂离情马嘶迎送地忆乡心送马蹄浮世往来人寒杵捣乡愁断肠来去路无人对幽景销魂短长亭尽日立西风
水亭::孤岛鱼龙水轩绿窗隔岸波光萍色红莲苔青绿遶芙蓉菡萏荷花平栏鸥鹭草岸红芰倚阑浦影苔痕翠柳萍嫩翠环杨柳蜻蜓柳月树头观荷暑退冷浸鸳鸯戏濯明月花光润晴波浮席四围清浪匝满阑红芰影池面避暑凉生寒澄枕簟凉枕寒流木气凉晓浪上帘一面画桥横四野绿杨阴草色侵阶翠水纹浮枕簟风动荷摇扇红尘飞不到月映林塘淡波光照座寒瓦影阴龟鱼萍开草掷金白鸟解相宜风涵笑语香
山亭::休休翠壁面面朱阑排云崩石卷帘枕石户牖鸟声松窗竹迳野草松阴怪石野藤岚气歌树飞云落日凭阑峰峦山色石榻松林林花花片残阴山鸟瀑声琴书润四簷风依峻岭出岫好云阶前山色润排闼千峰入野茅骈锦绣簷楹青嶂外枕簟香千障月踏高岩背人山鸟窗外鸟声清凭高四壁无林籁奏笙竽栏槛紫微中明朗千岩月松柏月中老清虚四座风猿猴天外啼
江亭::别洲绝岛浮萍蜻蜓浩漾潇洒碎萍沙鸥平野中波野艇?鶒空凉微茫残雨烟树临流水气萍开水纹长吟清江开轩乾坤指顾苔花岸上沙鸥没天风急隔岸波光沙暖瓦影野望白鸟倚槛风月吟哦荷柄水中烟树平鱼浪低浮枕簟江树临洲晚浴凫含藻戏鸟归沙有迹俯窥真净绿白沙留月色疏苇先寒折映帘笼沙禽对水寒惊鹭带鱼飞帆过浪无痕小立伫幽香绿竹助秋声残红带夕收晴虹桥影出秋雁橧声来
林亭::涧底小槛落叶白昼竹影苏迳逸兴幽鸟野风翠影庭前危簷飞花青山松声茅槛吟魂野猿山月绿阴傍岩野草竹坞危簷树色风扫叶松竹韵闻雀噪依林竹弄竹清风四围簷古木依树闲花山窗佳木山光鸟鸣枝藤萝阴乱蝉鸣透树莺挂松斜日一迳锁清风蝉噪林愈静乔木苍烟外风声鸣戛玉半空云咫尺鸟鸣山更幽孤亭落照间月影碎铺金百里境分明
园亭::美竹好花苔砌粉蝶奇花俊鸟莲房采鸳禽语秀草草迳曲砌佳景闲观荷香秋月漱石波光杨柳芰荷无暑花光名花苔阶危簷新诗静坐竹影春风倚栏芽色酴醾松竹有风波光蛙吹红菡萏歌舞地醉芍药竹引携琴入鸟归花影动浦深?涑鸟戏飞花随蝶舞水色莺簧碧琉璃绮罗人荡芙蕖花邀载酒过鱼没浪痕圆花暖鹧鸪眠艳曲伴莺娇侵阶梅影瘦林迩穿篱笋傍砌菊阴浓藤漂落水花
竹亭::清光秀色翠影直节落叶十竿满圃黄芽绿影清声清阴虚心鸣蜩三迳数竿翠叶明月独立竹牖风清菊篱无暑气涵物象松柏成三友雨窗轻影密低簷栽美竹微风孤吟柴扇月好藤架有清风傲冰霜烟霞卜四邻一迳远风清横榻赋新诗清宵明月照酒有陶公爱色侵书帙晚白昼好风生林希阮氏贤阴过酒樽凉
台::望海斗鸡一柱五仞三休避风画卦鹿游累土窥天戏马九层十成九累行雨说经凤去买金凌云望云春登望气柏梁积翠燕昭延士日月巡簷外豁达偏宜晚云霄遗暑湿望阙临风夏处画云铜雀浮霞明帝图臣山河萃目前高危易断魂山谷进风凉望极思乡处簷高楼上月千年余故国湖山表开基峻指中天万古只空台
琴台::遗音蔓草明月千古清松太古旧曲青苔清风四时夜月清虚红杏临眺春色风习习孤鸾别鹤清虚风习习暮云空黯淡高名传万古野花留宝钿苍松浣花午阴月团团流水高山潇酒月沉沉古迹竟萧条遗迹亦千秋蔓草见罗裙
月台::良夜拔地桂花雅宴登临幽人清宵皓彩如画中秋赏夜清蝉光满清辉侵云蟾影仰观观赏骚客胜景清光无云午夜登更深兔影低野渡波摇月停杯延桂影清辉周垒土空城雨翳钟举手揖嫦娥皓彩满层阶
钓台::遗迹两岸石迳风月烟外垒石清风群鸥松间溪山月中枕流芦苇折苇藓色崔嵬鹤发吕望去时一竿聊把握巑岏波甚处滩是垂纶处烟波荒烟苔痕重叠羊裘子陵归处千里自崔嵬潇洒月明中星非犯座时荒凉傍芦苇埋没近风波
书斋::薰帷松竹孙户颜巷书几石砚蠹鱼讲习一鹿雪案马幄林泉杨区韩窗文房牙签鹳鹊弦歌三鳣萤窗青衿灯火闭户几席欹枕书卷青灯鸡窗净几经史谈论弦诵窗牖黄卷简编下帷诗书挑灯琴声白昼夜雨明窗宾朋讲究义方诗文砚池观经史听秋雨四时事业万卷诗书藜杖全吾道得句邀新月闭户无尘事笔架对圣贤课夜书千古文章四围松竹榴花养太和披书挹彩霞开缄见古人堂邃春帷静冠剑轻千里往来无俗士灯寒夜屋垂琴书萃一堂谈笑有鸿儒萤聚月满竹影风声残简砚池鸡谈风虚花阴雪色断编书卷轻纱疏櫺雪映如霜试笔夜灯静坐草榻穷经士子小榻春风画为花安壁上薄纸虚牖月侵似雪题诗朝日看书短簷折桂才人疏櫺夜月秋和月到床前松篁新瓮牖纸开云母薄编简旧牙签绿染鸭头新竹影素书月色纸帐天欲曙焚香守白经史三千卷梅香清磬书声铜瓶人愈曜点易研朱茅茨八九椽枕簟入林僻竹密风敲玉桂藏秋色老夜映孙康雪茶瓜留客迟簷疏月镂金禽带夕阳归朝披曼倩书
轩::半簷避暑清风凉生团栾灵阶纳凉永日暑退潇洒双櫺傍水坐卧对朱户幕醒醉梦四面临山傍水开碧阑干爽诗魂绿阴风雨白鹤蟠空读书诗书清影龙蛇苍龙映日寻句醉魂密映百尺欹盖碎影山色月筛凤影苍龙腾屋角欲符丁固梦长恬高士隐高蟠数株拥簷繁声仙风风拂龙髯翠盖拥窗前故结谪仙巢不必大夫封夜静宜凉月声清听琴瑟浓阴浮几席秋深称远风势健讶龙蛇清韵彻帘栊
竹轩::筛月凉飙暑去清影秀影三径摇风晴影凉生寒声清声一帘风枕细声细籁夜窗老干冷翠筛风生枕簟声初到枕月镂无瑕玉浩歌风满袖月林疏影斜阳晓迳新枝萧森扫月入帘栊影欲侵帘风弹不调琴长啸月当轩谁开筵客迳俗客无因至独高君子节扫迳迎三益旧作读书堂此君相对闲长结岁寒盟诗高傲五侯
宅::一轩高斋甲第广厦三迳爽垲乙帐华榱高堂栋梁翚飞虹梁一区东轩蓬户何金推友垣环堵室百堵红药院深邃屋轮舆鸟跂鸳瓦四壁西垫桑枢薛土上亲栋宇班荆厦千间绿杨门掩笙歌归院落皎洁千年月凉飙朝满袖灯火下楼台氛氲万户烟皓月夜盈轩坏壁疏户池涸落花白昼庭户芳草空庭破窗梁空残月黄昏园林狂花径灭破屋颓垣蛙聚鸟啼寂寞野蔓花寂寞花无主空流水蒿生翠瓦池空荒池荒宅雀喧花落荒凉山禽燕西东草自芳不见人燕污雕梁园荒杞菊萧蛸在户山蝉穿户苔纹侵柱础无人花色惨蔓草缘空壁古木花犹发水弗龟鱼燕雀辞巢野蔓入窗竹色度邻多雨鸟声寒悲风起古台荒台雨尚悬
旅舍::往客逆旅旅舍宾馆野路关山旅思客愁羁寓客思止客来住迎宾他乡离魂乡书江村风雨羁情乡梦栖迟乡心留题淹留孤吟孤灯引恨寂寞夜雨残灯寒雁萧索天涯解鞍马嘶晓行寒毡独酌残月添愁萧条秋风落月秋虫荒凉海角驻马鸡唱暮宿晚笛古道三更雨冯驩铗乡关梦凄凉地月千里孤馆冷秋鸿惊客梦愁添连夜雨寒灯万里心王粲楼风雨愁摇落天天一涯半窗明夜雨感乡心恨引遶村砧异乡寒觉早松窗横冷榻草舍人千里孤馆千愁贮或国信来稀雨壁挂空囊茅簷屋数椽幽房半枕闲乘传置邮轺传蘧庐远邑驿马驿骑候馆往来驿使置驿续食置候娃馆近郊军书羽书驰传迎送征人尘埃走毂去旆舍静邮鼓秋夜仙盖岩柱别馆接輶轩秋风冷促装早道路奔蹄征鞍亭虚寒砧霜天使旌驿楼长亭祖远客夜月孤下程迟临江白日年年为客宾主更相礼轩舆来往客雁惜楚山远旅愁纷落木白沙留月色入馆青云日日送人门亭本不高烟雨短长亭蝉知秦树秋乡信断飞鸿绿竹助秋声
闲居::下帘静坐书案月庭高卧谈玄砚池雪屋闭门竹影栽花吟诗醉吟卧榻竹轩局醉眠竹斋灌竹导引寂静避俗花香种竹饮酒闲玩枕琴茅舍药炉吟步茅屋栽花燕伸清高地僻酌酒细书洗砚明窗鱼依藻春卧稳时抚剑花开落琴书鹤书能度日景幽抚琴浊酒烹茶古鼎鹤避烟夜冷多夜看书燕往来风月梧酒可忘忧一轩风月闲诵国风僻巷新苔遍不厌惟苍竹流水竹三迳静乾坤大抱琴看鹤去万卷诗书静销心火空庭弱柳垂相亲只白鸥清风琴一张闲中日月长枕石待云归兴阑鸣鸟唤坐久落花多石林树阴山禽白石清泉石径竹径野猿水禽地僻茅屋山色溪友苍松翠柏松竹柴门山鸟山果人稀云气啼猿草堂林亭野鹿猿叫竹阴移竹云山紫芝花香林泉涧花泉声宿鸟松牖草阁山鸡鹿眠云影流泉笋蕨青草松景笔砚溪鸟鱼鸢山容石壁野露荆树瀑布紫蕨风虎啸烧红叶泉脉细松根石溜麋鹿花气茅簷山花橘林溪云绿蓑露禽栖扫绿苔药苗肥屋上山云岚气入窗开户野云山光入画渥缨青涧曲池浅还容月松萝无限好山虚风落石瀑声落枕卷帘山月月色堪吟倚杖白云乡山高不碍云花竹不胜幽楼静月侵门茶鼎和烟煮松号无调曲芝田待雨耕石漱不弦琴野客芒屦浇花药蔓疏篱林深村路鸡鸣幽人松冠种竹芦花竹迳石瘦野桥樵唱牛巷桑叶蚕妇生涯枳棘樊蔬圃烟莎春钓静买山凭野客厨香炊豆角绿树村边合鸦村禾黍牧儿活计藤萝荫竹扉雪屋夜棋深觅竹到邻家井臭落椿花青山郭外斜种茶鸟噪牛巷稼穑桑麻荆花鲁桑种豆牛背莎迳池塘夜织灌稻泉流犬篱耕耘禾黍榆荚魏匏负薪钓矶石池场圃晚春蚕妇租税茅舍园桑红槿花日草迳花深花坞竹窗田亩窗寒瘦石牧儿征徭竹篱陇麦断藤竹风茅斋燕巢竹溪草屋农桑屋老苍藤茅三架田舍翁鸦种麦鸱芋肥青黄绕屋犬卧秋风暖风春睡足桑柞头绿菜两畦村落叟鴈知粳虎瓜熟紫白依栏牛鸣春草残雨晓耕忙鸡豚屋角闲禾堆深卧犬万里桥西路篱落水边静纵横一川水开筵面场圃林杪忽闻鸡百花潭北庄锄犁村外忙高下数家村把酒话桑麻
山居::古渡桑麻疏篱鱼蟹野艇沙头并鸭野色钓舟莲叶鹭鸥柳岸绿苔渔唱溪岸滩岸舟楫晓树鱼蓑船尾跳鱼滩声鱼火稻花鸿鴈水邻红叶棹歌钓竿松阴人烟春帆茅舍红蓼岸蛙两部清溪上隔岸花招客陂长流积水水色凉侵户渔唱来花迳钓矶白苹洲橘千头古渡头临流酒系船川阔尽斜阳滩声响遶櫺山光落钓船古渡一两树山川供秀丽山色堪图画疏篱三四家枕席转清幽溪声当管弦悬磬瓮牖蜗舍土床桑枢荜门陋巷佣书蒲帘牛衣瓦釜尘甑圭窦衡门破牖败衣席门虀盐藜床月蓬蒿一室纸窗明觉晓瓮枢无漏泽庭空蛛自网寒窗破屋环堵尘土土座烟榆荚满庭布被暖知春圭窦绝飞尘门静雀堪罗冷蝉歌几席迳合元乡竹饥鼠上琴书门深仲蔚蒿僦屋借车蚁穴三径携剑叠石问字金沙浒携家煖席蜂衙一区载书得邻移花浣花溪兔营窟人稀到穷成迁客赋静拟罗含宅鸟栖枝梦亦安疏称野人心疏称阮氏居
田地::春畦插秧园林夏垄操茧篱巷获稻击壤荷锄鼓腹鸣犬竹溪山田汉麦蚕箔茅舍牛饱社酒荒迳玉醅筑场含哺带犊杖藜卧牛林坞村舍吴蚕鸡埘柴门鸡鸣村歌空场香稻仓箱赛社村家黍苗犁锄桑麻牛羊雪稻桑重绿春雨歇桑麻地稻登场徭役输官市井桑叶蓑笠耕织鸡犬云桑稻正青杏花繁碌轴场桑环舍林外鸣鸠庭空堆谷黍雨多庭果烂枫林社日鼓呼童催放犊茧成堆白雪迎春犁瘦地屋头映日地隙植桑麻稻熟渚禽肥茅屋午时鸡留客待烹茶麦秀卧黄云趁晚餧嬴牛种竹草迳幽鸟猿啼竹密柴扇移花石崖野猿鸥集花疏竹舍险迳木古莺啭竹月松根远岸幽谷猿悬木竹侵局柴门深傍竹篆叶虫留字高崖泉幽鹿鸣松风竹笋空山茂林鹤步堂花落琴床茅屋险依岩啣泥燕理巢门静石为障养猿秋啸月就泉为碓屋卷帘通燕子屋疏茅送月地闲苔作衣放鹤夜栖松累石作书龛织竹护鸡孙壁密荻分霜
渔夫::竿纶网罟舵尾张网傍岸水国沧江波涛一棹孤岛晚浦柔橹钓饵丝纶沙头掷钩临流江乡泽国风月片帆旧江沧洲寒灯鱼虾烟浪撒网芦叶矶头红蓼带酒敲针平波蓼种江鹭蓬帆远红蓼岸鸥鸟秋风系船浪花浦口碧波捕鱼结网小艇芦花江鸥鲈鲙肥碧涛间汲湘江蓑披残雪沧波万顷蒹葭浩荡竹扉临古岸芦羹莼方熟一声江月夕窗侵红蓼岸燃楚竹钓拂红尘白鸟一声风雨飘零茅屋枕清溪鱼肥蓼正红三唱水天秋门映白芦花枫冷吴儿曲莲深越女讴
客栈::涤器樽前当炉青旗朱箔芳樽行客轩窗花外市上解貂瓮下折券翠槛青帘酒旆醉人栏槛柳边樽中饮客金斝华筵野店小桥宴饮风月酩酊三杯杨柳岸刘伶醉花藏坞游人酒筵醉客山村垂柳登临溪山笑语一醉杏花村李白眠竹锁桥杏繁村店远百钱酬酩酊神仙留玉佩座上客常满尘外黄公市举杯邀皓月杯盈浮太白竹暗野桥横四座竟喧哗卿相解金鱼樽中酒不空云间李白楼抱瓮对清风樽小滴真珠
庙::春祈祈祷仪从璧像威灵汾水杞典草木千载英风年年箫鼓虚庭祥獬豸秋赛英灵祭祀香烟壮丽姑山神灵山河一时灵迹岁岁牺牲古壁画龙鱼鸦归暗庭树威灵扶宇宙巫拜荐江篱恩重福生民曲阜泗水阙里两楹笾豆众贤礼器衣冠昌平尼山杏坛百代簠簋群弟先师礼乐宫弦诵堂殿堂庑嗟麟鸿名垂不朽春秋严大祀五经环几席德大千年祀释奠门学宫窗櫺叹凤盛德播无穷今古想遗音十哲待衣冠名高万世师礼容观俎豆乐韵听弦歌壁破荒庙万古有雀遗像苔壁荒祠冷落垣颓断碑千年无人古碑蛛丝古木凋零丹青落碑横砌苔壁暗屋破香烟湿一时遗像在庙貌丹青古石柱龙蛇绕古殿今犹在鬼神哀雀啄蛇瓦炉空庭空日脚斜千载古祠存威名岁月深云楼彩翠销庭空草自青风筝吹玉柱露井冻银床
祠::金麟雨湿巨浪泉心蓄雨雷鼓分水膏泽滋稼穑三日雨玉爪烟埋千年海眼藏云电旗溉田恩波弄风雷寸肤云玉虹横作浪霹雳朝扶卫丹蚀斗为簷风云夜警严配享二丁释菜威仪宗儒樽罍庭燎八音奏乐礼尊牲牢万古扬燎币帛祝史苹藻宫悬三献歌诗乐备肉升俎循周典帝王尊明祀尊常典六经悬日月春秋严祭享桥门多士集俎豆兼三代乐在悬继汉仪人士敬登歌奏古诗二祀照乾坤上下肃容仪斋庑庶官随樽罍奠两楹王道闻诗乐秩秩严明祀遗仪见豆笾煌煌辟古祠
寺::三刹七重下界名刹净界宝地精舍珍楼宝阁沙界灵峰净上缁庐兰若卓锡白马上方化城祇园金田梵宫宝屋花龛龙宫玄寺招提绀宇曹溪布金青鸳煮茗粥鱼禅房古壁佛阁讲殿精蓝石室烟霞云间竹阁飞楼宝树猿鹤参禅斋鼓丈室行廊经楼禅堂佛像云龛云水木杪松阴朝鼓云华竹松幽堂咒钵香成雨夜堂鸣竹雨巢鹤和钟泪绝顶登临日景散天花雨苔藓山门古高阁经坛福有田春院落花风诗僧倚锡吟长林笑傲时声传贝叶经丹青佛殿空山光悦鸟性铎声青霭外潭影空人心塔影乱松间蔓草磨灭苔藓落花凄凉荒台坏壁瓦砾苔花摧颓松杉啼鸟明灭静庑古碑蒿莱丹青落知何代满地绿苔猿笑石屏山深微有迳土埋碑字没爨烟寒寂寂古殿人稀到岁月深不计年穿林明月龙归云井树老半无枝雨退佛头青香火冷飕飕回廊藓遍生月照何年树花逢几世人龙井绝顶寂尔烧药石龛半山萧然依岩寂静方丈松叶养性泉石茅簷松屋参禅客三乘法净隔尘中事尽日客鲜到萧条圆庐茅堂悟空山林草宇草庵采药翁一炷香便安物外身有时风自清逍遥安静室清闲聊扫叶暖觉春常在清洁一空门寂静好参禅闲来景自幽福区蓬壶壮丽洞府琅函仙帷竹几灵境云洞清虚仙诏石窦宝盖芝房青鸟彩云丹井野鹤珠树楼台石坛碧海玉座琼楼霆旌栽花瑞草紫云白鹿漆园毒龙琼台宫殿金灶玄都星坛金阙鹤驾采药奇花苍桂云芽丹穴桂影鸾鹤烟霞黄卷碧窗夜坛绝涧青牛玉坛醮罢紫芝石发露盘松声松篁星斗苍苔宝殿暑榻山岩黄鹤金鼎药成清虚人事少草迷幽洞邃鸟啼青涧蝉似谈玄妙羽使来三岛三光天地宅占断壶中景寂静道心生云锁石堂深花落白云间花应悟色空胎禽舞九皋五彩玉真家长为物外华慈室坛林斋钵圆觉食罢三乘挥尘处大千界佛面金销暗慧门精宇佛灯维摩茶烹十笏散花时不二门僧眉雪点斑池暗龟出曝地荒苔渍壁鸟道蟠晴雪松暮鹤飞回人静石蒸云鲸声随夕曛
塔::宝铎风铃冰虬面面玲珑插云突兀金轮云栋金铎层层屈曲倚汉峥嵘回梯星灯地高崒嵂风吹虹千尺晨铎响高招碧落日观千里远铃声摇宝铎绝顶风铎天近虚空日晃玉一峰夜灯浮俯视红尘身举九霄中倒影落晴空嵯峨千尺相虚簷侵汉远梯转如穿窟万山江外尽险峻十三层危顶插云高门开似出笼一塔岭尖明
圣寿::嵩呼龙楼蟠桃延寿电绕称觞无疆五老龙飞千秋知气南山华祝凤历金狄介眉虹流祝寿永久千官虎拜万岁欣声北阙椿算瑞气四海千年开御宴乾坤大陈金镜延寿杯山河固红日晓圣恩长龟龄祥云一人三祝醉仙桃日月长献玉杯长春节箕翼延碧桃春仙祚远开天运金鼎御烟御柳垂闾阎金镜千秋绿雍容九五福玉帛朝朝贡席上风云会庆瑞辰玉杯寿酒仙桃熟建章瑶池万岁觞笑傲八千春金炉岁岁烟壶中日月长凤鸟临花暖嵩下三呼日龙炉傍日香天中万寿辰青宫出震鹤驾颙望满前星色正宝月重轮绛节重离龟龄瑞光新少海波清祥烟浮爝歧嶷亲王羡庭阙瑜瑶满菊蹊浮喜色讲筵心会道入省龙楼晓聪明左右惊储宫瑞彩浮兰殿仗欢声宾苑礼通清归休虎阙春
诏令::紫泥尧言丹凤黄纸文命黄麻丝纶纶音凤尾德音丁宁号令涣汗凤口五色视草悍卒感六龙扶日雨露喜色马前文诏典雅文章濡云泥封十行制词老癃听一凤啣来金阙九重雷霆驱号令天语丁宁处玉历当年运仁风随鼓舞乾坤开寿域禹迹山川外丹书一札星斗焕文章皇恩旷荡中黄麻灿十行化日亦舒长雨露布天书尧天雨露余
赦::升台动籥设坛小惠躬耕东狩神光涤瑕鹤留鸡竿更始巽风录勋委辔鸣条解网大恩亲政南郊芳气荡垢鸾举蝇笔自新解雨改过蠲逋德泽乌夜啼景星见哀黔首鸿恩重风云改色光照蛰幽国严三岁礼赐帛皇恩贯索见驿马流服远人喜色新蛰虫回春润沾卉朽恩洗万家春青简流远芳书报天中放覆盆俄照日丹凤纶音至丹书霈泽倾人闻海上开蛰户忽惊雷苍鹰狱吏清
赏功::甘田明德金钩千金鼎彝分茅元勋青裘剖符赐珪铭銕券苏宅计功玉玦万亩竹帛裂土茂绩白璧作券锡爵锡锦袍汝南帛启南阳图麟阁赐鈇钺著金石竹帛昭新绩茅土加名数绩纪太常上辽东钱受北国画云台锡土田铭鼎钟山河复故疆山河誓始终勋藏明府中岘首碑空立兵法一编力塘溪石再磨侯封万户荣增秩励廉功劳磨剑代耕驭富世禄诏功丈二组方寸印
贤士::富义朿帛加璧方正式庐砥节玉碎冰清播仁安车裹轮孝廉前席砺行金贞玉澈梦想国器建旌须汲黯安社稷增辉日月形求人表招弓忆廉颇主神明垂光虹霓
忠义::运瓮当熊碎首石心瞋目卫难义气严霜颠危大节推诚疾风枕戈授马啣须松操剖心犯颜忠心劲节板荡贞心授命烈日丹心义高山岳志全节义英雄尽稽绍端冕扬仁披甲张飞横矛勃苏昼吟壮气礼重铁石心耻奸回日月悬王堪仗节应詹负戈姚期奋戟许肃夜泣龚胜推印一代名超古青云悬器业忠义三朝许复仇垂夙志彭泽不书宋遂闻王触死胡刚悬冠千年泪染衣白日贯忠贞威名四海闻忍死罄余忠东坡无负秦不见华元归使知临汉日犹有不敢臣
谏诤::尽规折槛借箸逆耳扣马面折顿首鲠论绳愆言事献纳叩墀引裾批麟汗轮口陈当车忠言补阙献书骞谔谟猷每于言事际有意箴丹扆排云叫阊阖晓随天仗去忠贞风彩便作去朝心无心坏白麻披腹呈琅玕暮惹御炉香
刚正::正气骨骾耿光锋棱断腕谔谔震动严霜有鳞角名姓重资上策波中砥柱济时行道不阿不激坏麻惓惓山摇烈日震朝廷骨头香佐真人雪里负松后乐先忧无党无偏不负所学文章正印有得于天至天松不屈不随冤气散莫干以私气节大闲其清如水无人兰自香常逐剑光飞
循吏::父母拔殣儒术神明买牛孝行遗爱保障鸣弦兴学卖剑清明爱民简易民讼息门馆无私虑淡常高枕怀恩裤襦制锦还珠买牛镇静敦教笃诚政声优阳春有脚官闲日闭门制裁由礼乐忧民如有病政成琴瑟好决断若神明见客似无官歌沸裤襦传
廉吏::一钱四知瘗鹿却宝玉壶斋马百纸三异悬鱼付金冰雪釜鱼冰清串茶醉玉不贪清标持雅操冰壶烛物三年清似水县古槐根出见客但倾酒玉洁孤鹤挥金至洁廉德播芳名玉尺持身六月冷如冰官清马骨高为官不受钱无瑕胜玉美有官居鼎鼐至洁过冰清无地起高楼
能吏::料敌强项钩距有衍盗息承诏东海冤山兵动宣威铁心推豪如神讼清运筹南山判鬼神愁资治化不鸣鼓筹远略德回暖日搏击豪杰南山可动力扶国运落笔生绮绣静边尘复还珠济时才令肃风霜摘发奸邪东海不冤文占时雄操刀振风雷
宰相::日月耳目经纶柱石霖雨弥纶钧衡黄麻秉均黄阁绣裳老凤风云股肱鼎鼐台星盐梅燮理管籥赤舄补衮黑头绛服卧龙小车堂老槐宰伊鼎为舟楫调玉烛兼文武宅百揆善谋能断金榜阴书别墅鼎臣铉玉传岩作栋梁覆金瓯理阴阳顺四时应变守文纱笼神护吐哺下士玉陛天颜近咫尺亲龙衮赫赫公台位位应三星次德望隆黄阁启沃天颜侧开阁招贤金瓯帝命尊从容步玉堂潭潭相府居躬调七政尊谋谟赞紫宸雍容玉殿中
翰林::附史玉府锁院玉堂视草八砖官箴水天花砖翰苑登瀛三岛金门紫霄青钱銮波紫薇草诏铃声紫诰玉绳天禄虎观裁成承雨露丹地玉署金马鼇禁红蜡题诗日影黄麻金带石渠灵台纂叙被丝纶双鹊噪清虚府典文章陪侍从刻玉版奉缥囊恩分雕镜法酒封来宠号私人五凤飞尺五天知制诰应传宣藏金匮携翠轴宠撒金莲锦袍覆去荣称内相兼擅三长槐树厅前朝夕论思集贤学士凤书裁五色白麻红烛夜清光依日月勒成一代海棠枝下出入承明丽正文儒马鬣剪三花清浊紫微天逸思绕风云凤诏夺袍手御酒倾壶满振佩趋台阁金貂贳酒仙宫花插帽斜抽毫侍冕旒
御史::乌府绛驺鹰扬豹直白笔理轮柏台白简虎视鬼参绣衣横剑赤棒豸冠骢马触邪鸷搏兰台明目屠龙内外肃无回避纪纲地风霜任青囊铁面皂雕除奸鹰惊柏府张胆探虎黑白分不吐茹耳目官雄峻官植风声号七贵五花砖二台纪正云汉文章备直干终为栋破柱行持斧鸷鸟得秋意总宪度会三司千步道八印提纲风霜号令严真刚不作钩埋轮立驻车法星悬太旻出关春衣绣风连台阁起分符夜乘轺霜就简花飞
学院::棫朴泰山琢璧建旗玉壶菟扬菁莪北斗披金拔帜冰鉴甄治造士化雨秉玉尺操鑪锤收翡翠贮参苓如綍如纶地接文昌绛帐高悬陶冶干将作人春风度金针悬衡鉴网珊瑚栽桃李为衡为水胸罗武库青衿志喜抟扶鹏翼
刺史::隼旟松寺嘉禾衣锦朱旛高车挂床露章帷裳褰梦三刀清见底熊轼兰堂甘雨赐袍银印运瓮遗犊叱驭竹马迎合万石照无私六条问事甘雨随车邢邵清风卫森画戟千骑临民贪泉酌水庾公明月寝凝清香
太守::银章铜府卧阁悬榻饮水守土青绶竹符悬鞭还珠携琴专城朱旛竹马承流虎幙弹燕挂鱼受一钱神雀降拥群鹊歌五裤前龚黄皂盖满鞭宣化凤池凿山渡虎卷五果白马翔坠飞蝗麦两歧后召杜理庶绩去攀辕咏白苹坐啸风高白鹿夹轮一天膏雨一麾出守醉翁亭上典名都殁奉祀森画戟催科政拙黄龙守府千里仁风五马先驱虚白堂中声名天下重汉节从分竹落日双旌远道济温公志权分千里重功业万方闻刘鞭不用蒲西风五马迟忧深范老心车饰两番荣
县令::黄缓茧丝荆玉强琴展骥一邑百里涂歌白乌明府刻石铜章保障南金制锦割鸡千家一司里咏青鹿慈君置祠冰清十奇五株柳甑生鱼米五斗飞凫化履系罗公马变井成甘颖川四长玉白三异一县花庭集凤食一升驯雉依桑牧鯸氏羊穿渠利用蒲邑三称虚堂悬镜烟柳千家晓割鸡才暂试云端双履冷诗成花覆锦道僻相如节暂非三年令玉壶贮水风花百里香驯雉政应成花里一琴闲酒洌草成茵堂清子贱琴元非百里才闲官射鸭亲人黄绶除寇国器贞清春色迎袍绿已作观鱼槛晚秋宜看菊少府弹琴佐理青袍化民仙曹惠爱晴花拂绶香仍开射鸭堂湾谷不藏兰节高名已富楚歌停晚醉禄薄家不贫蛮语入新诗别驾推官治中半刺端僚别榻绛鱼疑谳六百石缇油轼春满座舒骥足酌水明清化鹤成仙部尉题舆白马雪冤五色棒曲翳车月悬秋赠佩刀留佩见意击蛇消异才非百里望属三公
教官::印钟官冷霑化雨游缁林乘一马空盘苜蓿振铎师严坐春风设绛帐集三鳣泮水藻芹通经夺席槐市衣冠时世矩范人立三年雪诗思春云外乾坤夫子铎坐客无毡杏坛弦诵治化本源官除两鬓霜书声夜雨前岁月广文毡
荐举::先容白屋贡名齿牙论六十家药笼参苓长涂一龙孔荐弥衡推毂管库长价夹袋中七十士公门桃李百鸟一鸮杜推苏赞
入仕::入官试吏蛟龙仕路致身紫气持节离白屋岂是池中物紫阁开霜匣蛟龙得云雨云雨居官佩印青云赐袍走青云由来席上珍青云倚玉梯鹏鸮在秋天雷雨群龙会云霄一鸮飞
除授::龙跃奉檄披云迁吏部占光气恩斯厚待诏宏文一岁大夫莺迁登仙陈戟擢中书越清班荣莫并骤登宰相旬月宰相
辟召::羔币蒲轮起莘安车下士封车表敬一辞芒蹻东阁招贤不乏忠言玄纁旅帛载渭束帛求贤劝驾致虔遂上金銮北山贻诮何伤雅操南楼孤月冷白屋人难料日暮长安道凤啣丹扆诏苍生待霖雨北阙景云深青云路有期秋深云汉心龙跃碧潭津白日奋泥尘
赴任::趣装判笔命驾下车视篆铜章绣衣紫绶驿骑勋名重披书辞北阙斑衣随授节白发临漳水分符墨绶玉节金章溪船宠渥新持节入南关书鼓送行舟青云动楚山去瞻南岳鴈文称一道重霜风催远役度关风散暑行背上林莺政类百司闲秋色入新诗下濑月依船
谪仙::去国孤忠逐客抱恨投荒一点骚人书空海隅黄阁谪宦去国迷宫舍徒受谤屈原湘泽身轻似叶江上同三点生涯投岭檄泽畔朱崖离愁高名认故园竟堪怜贾谊长沙名重如山天涯酒一樽世业陷边尘青山数行泪落日独归鸟草色依征路沧海一穷鳞孤舟何处人莺声傍逐臣
致仕::解印鸥盟绿野自由投簪归杖挂冠鱼钓东山真乐解组悬舆万石小驷乘黄犊门边罗雀折腰何苦致政辞闲未满宜先退退想裴公野二疏角巾焚银鱼洛下思莼投版非愚功成身退归闲不厌贫归思范蠡舟
登科::烧尾贤书月窟凤苑怀珍已久鸮荐横秋雀闱擢秀笙簧式燕鹏翩从高举扬鬐龙榜禹门燕台脱颖自殊鹿鸣食野帝阙扬言旗鼓登坛桂花向上扳豹变南山雾鹏抟北海风龙门夺锦榴实金花澹墨红绫饼人镜芙蓉三条画烛鴈塔探花槐花银榜泥金玉笋班春官桃李千佛名经紫陌寻春贡树分香宴停银烛桂林一枝春来省璧马度燕山月声重周南价吁俊龙门敞青云得路天街软绣泥污锦鞯昆山片玉芳发灵椿花飞汉苑香文空冀北群乘时鴈塔题玉殿昌言日班衣行乐近金门射策时鴈塔姓名扬白浮目迷无栖燕文星易暗贻诮网官孙山答友红勒腮暴失水龙花样难同频伤眊燥刘氏寄夫积木乘龙剃髡给七一桂树枝领袖群仙色夺红笺胪传玉则衣鲜柳汁登梯生菜渴睡赋五色梅花味高根一桂香生彩笔名冠多魁镜绕芙蓉江夏无双标能夺锦独步上林天子门生独奏三千牍汉庭第一袍是彰轮前驱阆苑状元宰相还魁五百仙
座主::鸾仪帐礼闱自添错烛凤味堂生明败见花马鸟庙堂衣针昔年辛苦摆神却金既主群材焚香答进士桃李春官此日羽毛授官避甓休迷五色撤幕待诸生泮水青衿济济选秀阶采芹黄序祁祁登云路制取虞周圆桥观听价等连城璧雨润芹初绿风云随绣虎长才窥学海人皆邹曾鼓箧衣冠才成百钺土秋高桂有馨烟雨待惊鸿彩笔焕文星
祖孙::兴宗宝田金篦置书名家龙孙含饴瓜绵瓞效传呼陇上耕耘诒谋盘石石砚遗笏风骨燕翼金寺白桐生枝严归谒桑间修植每诵先芬绵若葛垂芹生大泽时陈祖德森如竹立粟出西离
父子::桥梓箕裘隔坐一门德星整肃凤毛楂梨椿桂齐名三绝珠蚌显荣骥子问寝俯仰林苏子印窦禹义方暇日从时饮学语转春鸟试吟青玉案膝上王文度趋庭夏冬日老莱衣苏洵科制明年共我长涂窗行暮鸦莫羡紫罗囊家传张长公
母子::树萱杀鸡还鲜断机倚门知贵露集导舆埋蛇紫诰鸾回纸寄鲜进果埋钱伏剑截发显忠乌翔尝吐噬指清朝燕贺人奕业★姑史门无黄金聘慈母手中线芬芳孟母邻家有白发亲游子身上衣
兄弟::同气羽翼共被花萼联珠金昆连枝手足识声鴈行双璧玉友棠棣三凤二陆三虎龙驹辍讼联芳同擢第春草池塘拭泪沾巾血草黄骐骥病鹡鸰八龙五常双珠凤雏问衣并秀不分财夜床风雨梳头满面丝沙晚鹡鸰寒对酒都疑梦传乌鹊喜吟诗正忆渠恐负鹡鸰诗犹子璠璵痴叔病十起竹林游蒙正举自闻茅屋起比儿经纬才姪人非常紫囊戏仲容贤只想竹林眠满谷山云起耕凿安时论隔沼连香芰侵篱涧水流衣冠与世同通林带女罗
夫妇::画眉齐眉锦封如宾荆钗射雉分镜举案镜约执爨布被化斋回文供笑语歌黄鹄感孤燕蓬首请罪封发话平生怨白头卧牛衣写真寄诗金玉戒下机同甘苦花牋印去松筠索诗送傲雪霜锦牒来千里想思素手掬青霭夜长灯影灭几番欢会杂衣生紫烟天远鴈声孤侧室染发玉箫碧玉桃叶妒宠列屋专房话梅络秀绿珠柳枝争妍闲居莺莺樱口皓齿仙姿箕帚妾章台柳花已老五夜有心翠袖香残紫鸾舞镜燕燕柳腰蛾眉玉质花月妖金谷楼月犹残百年无恨青楼云渺青鸟啣牋樱桃樊素口杨柳小蛮腰
孝子::怀橘竹笋潘舆棒檄涌泉彩衣卧冰烹鱼扇枕驯麑导舆江鱼卫幕锡金跃鲤春酒负米分椹驱蚊搏虎陟岵孤云佳节驻骑泣杖朱颜在白云亲舍卫幕啣恩重委曲承颜体远传冬笋咪登山双日异乡望云得鱼白发新黄耳家书潘舆送喜频骞飞报主身更觉彩衣春圣朝新孝理云沉亲含远祖席倍恩光风动鴈行斜义方摊书择邻教让画荻断机勉学白首绝长究庭训觅句画鹘成贤鬻书和胆助勤青衿酒解温欲折三秋桂须穷万卷书
婚姻::朱陈种玉凤占玉台屏雀星期玉杵执鴈鸾匹双雀屏莲花幕吹箫女秦晋吹箫鴈币青鸟河鲂月老朱丝乘龙凤鸣九子墨三镜台傅粉郎路入桃园翠凤好梦花殷烛烂良夜乘龙月寻鸾扇下仙配人间少桥横银汉红叶良媒云娇月溶灵津驾鹊星向鹊桥飞云骈天上来射雀买犬乘龙牵羊冰清留诗疏旷好酒珍玩还钱婿快穷窗擅文章美姿拔俗隔幔牵丝玉润投卷风姿能诗绯衣归产翁痴眇日耽蒲博呵气成云东床坦腹诗得津梁修谨自足果获麒麟骏屏开金孔雀书偷玉轴老成见奇何妨鹳雀容褥隐绣芙蓉
悼亡::吹灶朱愁琵琶锦梭歌扇炊臼粉瘦鹦鹉罗袜舞衣彩云泣冢鸾镜在悲难尽肠犹转花落桃源风散彩云帐添闲翡翠明月留歌扇金钿断弦凤楼闲夜更长泪未干海遥蓬岛霜飘寒菊珮冷朱珠玑残云散舞衣尘入罗衣暗终期弹琴好春风闲鲁馆香沉玉篆消何惮鼓盆歌明月断秦箫泪残春寂寂遗罗袜海枯石烂月暗秦楼肠断月娟娟损玉娇地老天长云迷洛浦花信尚留旧亭红粉阁镜掩巫山月花落肥脂冷梅魂空负宿处白云关香埋楚岫云魂消锦帐寒
师傅::函丈经笥指南扣钟绛帐稽古春风泰山模范槐市舌耕谈经源渊★堂待问鸣鼓元龟解疑冬月北斗表仪杏坛腹笥讲道抠衣面北南郭西河列传经追风雅龙门高隐附近朱槛请业请益师术有四设帐易东东陵北海作寄字近典谟鹿洞清规无烦夏楚经师人师民生在三传道解惑鼓琴吹笛吾道宁终否洙泗风何古荣辱风飘瓦学问知真处绛帐春风足博古知今奏雅歌南群儿赖发蒙河汾道不穷行藏日在天文章归道中青灯夜雨多身须为道重志不以贫降
弟子::升堂祁祁负笈坐风抠衣瓣香献粟鼓箧横经执经入室济济担簦立雪发箧芒屩裁衣担囊问字请业问难升堂尊道德弟子已扳桂江湖双倦脚执经勤问难步趋接武重规模先生犹灌园山泽一P瞿儒负笈远从游
交友::神交断金分金心契伐木赠纻结绶倾盖莫逆云霞凤举高山解带乘车盍簪到头金兰金石莲社弹冠班荆忘年杵臼鸣轩流水披襟戴笠丽泽隆德胶漆芝兰剡溪淡若水历风雨共山林裹饭相存拜母升堂翻云覆雨信渝白水少赠绨袍兴悲河上臭如兰隔云泥同砚席指囷不惜谈心达旦隙末终凶色落青松谁怜葛帔致叹谷风谈交人所易鱼鴈通远信诗章夸李杜一别星桥后义合古来难金石结平生胶漆重陈雷三移斗柄春
怀念::孤吟夜月倚楼关山怅望春风极目风雨对酒魂消寸肠梦回久违秋鸿地千里鸿杳杳江山有路双鲤附书心旌千里荡临风目断尺素酒醒凭信社鴈天一方蝶悠悠鱼鸟无情两萍浮海梦蝶几宵飞落日空骚首一别几春草寄梅心欲折日月淹书尺水流天不尽清风渺盍簪相思空暮云托鴈信难闻江山入鬓丝人远思无穷则赋千里月独吟招隐契阔思良会投壶深竹寄诗一枝梅因访草玄淹留叹不才系马古松间离别留诗卷汉节梅花外吟卷看花掩敏忆诗千首登临罢酒杯春成海水边行床傍竹眠飘零酒一杯
访友::命驾鸡黍迎门茶瓜千里陋巷寒盟惊座相思青眼联句骑马二年隔绝片言成访约月夕评诗榻十年柴门爽约对床旧话赤心添杯扶笻百岁相逢一见即平生花朝漉酒中不辞千里远鸡黍有成约夕园依绿水成此一般奇关山岂惮遥野竹上青霄下榻叙别握手开颜盍簪开樽论文对床话旧倒履白饭欢情相思贫居开门来千里话十年旧喜同今夜月有客过茅宇久分交契密青刍惜别久渴佳客扫榻醉一觞穷一夕欢叙别几年春呼儿正葛巾坐得笑谈香兴因樽酒合正思居处僻乍见方疑梦愁为故人轻忽喜故人来相逢各问年清谈携笻坐久寒漏为思清论良夜缓步轮斜清风恣看寒光麈尾轻挥玉千里共明月螺杯冷漾金一樽同故人何处题凡鸟鹤相对空还问主人人未归云碓静闲来寻竹迳君去拾瑶草不逢诗酒侣踏霜归远店石碑闲久坐落藤花予来空白云空背水云乡凉月照空樽
宾客::拥篲悬榻投辖开樽迎郊填门蹑履开阁招守造门契合扫雪朱门长不闭坐对贤人酒每登徐孺榻曳裾画门西守酢弹铗疑留盈门情友自相过门迎长者车频接李膺舟
人材::绣虎人瑞三杰一鹗璞玉奇才国瑞骊珠第一海鷴威凤凤雏玉山天才一夔六龙浑金伟器人龙丰剑无双天马卧龙骥子家宝南金道学伏鹰清朝器公辅量王佐才五色线赋一物秋佩印声价重国珍北斗神明卧虎治世音端揆才非常器八斗才诵千言夜鸣珂姓名香德比珪璋海内斗山明映冰壶清庙瑟三叹清节冰壶莹柱石千人杰岂是池中物品同琬琰朝端柱石清标玉柱斋房芝九茎孤标玉树新珪璋一代儒由来席上珍庙谋藏稷契兵略贮孙吴
诗人::白战笔力气豪杜诗才高得句五千卷扬元彩曹刘敌清词词源笔健韩笔吟苦搜奇二百篇吐绣纹李杜坛寻灵草思倚马联星斗认屈宋踢翻鹦鹉逸韵声金五车学赡胸中斧藻高致屈宋艳拾落花笔生花揽云烟薄风骚分得凤凰高标映玉八斗才雄笔下宫商浓薰班马香日月精华薄笔力千军阵清新庾开府山川千古气山川气概卑词源万马兵俊逸鲍参军风月一时清
神童::上书通义总角骨秀正字属文垂髫神奇敏悟通经骥子名驹龙种妙龄兰芽食牛国瑞聪明群儿服如夙诵驹千里清彻捷对麟儿英物凤雏秀气玉树吐凤天成迪启众客惊不劳思桂一枝麒麟种良玉不雕当殿赋成年将几弱冠通经如夙诵精神方总角人间金鸾旅鸟凤凰毛灵根非种内朝宣看学已擅名家捷对不劳思宾客尽回头天上石麒麟精神应更爽五行才并读答问自如流七岁已能文
公子::风流斗鸡挟弹娇马青楼九陌玉勒朱履豪贵走犬击九艳姬平乐五陵紫箫玉鞭连璧宝马笙歌走马锦袖轻飞箭买花去梧桐院终身乐户啣金兽深院吹笙仙丹雕鞍罗绮援弓玉街缓著鞭沽酒归杨柳风到处游帘坠玉钩静街调马马上臂鹰五陵侠少昼游花市里香飘罗绮院柳边金勒映笙歌归院落晓日寻花去袖中携剑六郡良家夜宿锦丛中花簇管弦楼花外绣衣明灯火下楼台春风带酒归连钱爵金勒凿落写银罂
风向::风姿额犀凝脂钉座春柳光风秋月星辉璧立玉山仪表目电傅粉出尘瑶林霁月冰壶月朗澜回岩电赳赳风流乘车风神秀心似鲁连子言论琼飘屑矫矫艳丽挥麈志气昂面如裴晋公风姿柳弄春
武士::枕戈勇略威武带刀执戟爪牙扬威挟矢军中干戈铁甲秣马虎旅充后殿安边功业英声怀绝域气焰麾星斗平生习弓箭塞上攻击锦袍弧弓龙骧作先锋许国精神威德镇穷边威棱震虏庭岂复问诗书剑挥江日落旗飐岛云翻
老将::霜鬓矍铄百战谈兵心铁战胆囊沙拔帜授钺身老心犹壮灰心英雄六韬布阵鬓霜壮心刻石避矛肖据鞍年高计益奇青襟今日幕灰心缘忍事自觉丹心壮何曾画麟阁细柳旧时营霜鬓为谈兵宁忧白发班祗是老辕门
老臣::衰颜鸠节龙宗眼花白发鹤发矍铄鬓雪病骨倚杖庞眉雪鬓皤然心灰头垂鹤骨衰齿头如雪龙根瘦春光短衰筋负暄皓首冰髯老矣形槁齿落霜髯余龄眼更花鹤发疏人事非携灵杖淹留岁月去作忙官桑榆光景数茎白发几杖不离席道正愁还浅白发千茎雪驾小车汨没风尘退成闲叟松柏岁寒一梦黄梁子孙常满前年加睡却轻丹心一寸灰冲寒骑瘦马本无丹灶术认影识衰翁那免白头翁
隐者::卧龙耕云踏海避地龙蟠云楼韬光出群栖凤钓月归山逃名豹隐木食晦迹避俗箕山归田诗兴逸纷华外林泉静洗耳颍川水青云无彻迹豹向南山隐一榻坐临水颍水招隐世缘疏寂寞中夕霭间疗饥商岭薇白发有柴荆龙来北海蟠片心闲对云窗列四君子一瓢清乐韵泉石平生事门客五大夫三尺古琴声山林日夕心
高杰::三径洁身食笋高卧四皓草庐五杰洗耳种瓜隐居二疏蓬户三宜休洞连龙穴严陵卧心同野鹤生不书名蜗角千钟小身世太仓粒邱山高道义五不住窗透鲸波范蠡归诗似冰壶死堪配食鸿毛六印轻乾坤沧海沤草芥土功名浮云时事改巢由不愿仕孤月此心明尧舜岂遗人
相者::观形贵贱择术月额伏犀牛腹龙行燕颔辨色吉凶知人山庭鼎角鸢肩凤颈虎头奇骨紫胞测黄气面长身悬珠编贝瞳赤好杀欲论襟怀里山庭知有异辨色知愚智手文乌喙占青蝇眉过目猬毛召棱耳白闻名难逃面目间口角识非常观形识咎休空灵三寸舌不疗一生贫
占星::揲蓍开市协吉闭肆吉凶研穷青囊阅数四兆推步谋筮拂龟决疑下帘祸福推测黄策画神五行知来悔吝兆三避屋崩古八颂何待卜审吉凶彰往察来青莲神祭筮短龟长乘皇策文咎休揲四消雷厄悉五繇不须推知去取穷神知化翠野灵蓍策圆骨智启青正秘铁笔一枝聚雪连山鸣凤启仲文中能审象立爻三画变阴阳藏智府金钱三字密云拥气非熊兆姜言下可稽疑四象八方成休咎相灵龟谈天穷通知命寿夭六甲旺相五行四余都利经先天学如布定知前定吉凶悔吝能知廊庙器三奇盛衰三命七曜定真论列宿图预能知究后来富贵荣枯先识栋梁材胸中千载历掌运一天星
医者::起死察脉秘方青囊丹房扁鹊杏林金液玉版出蛇回生通神良剂金匮药境华陀橘井银丸紫书走獭徙柳换心三折肱调九候观虚实追葛氏医国手丹存鼎洞见五神丹调国脉针茅理脑一声肠成千金辨君臣继桐君活人心药在囊明知二监术起民疲药炉火足阴阳相配神农尝草盛丹须竹节脉占心腹病丹就凭仙掌茶灶烟闲血脉为根岐伯典医量药用刀圭药贮太和春春回有异方
采药::披榛荷锸采苓披云千般尝味俱收带叶折枝和露拔卷蓬华访蓬莱诘隐者苁蓉肉寻术度岭万品知时并蓄连根摘蕙倚云栽采芝茵贪药饵问山童薯蓣膏葛仙经高高不惮一笻凭历险灵根宜细认来往登高去越云衣染湿农皇帙细细重寻千里贵知名嫩叶更重寻徘徊缓步行过草袖生香三品四家捣罗寒温虫鱼名方异品神农尝草寒热阴阳炉里金丹物先观上物妙诀宁传俗炮炼甘苦金石妙术奇方鸿术为医君臣佐使月中玉兔方必按名方灵丹必驻颜风前香气郁有功皆救治月下杵声寒无病不消除
地理::青囊玉函藏风挂月牛眠湖灯择土锦囊经赤雹金斗聚水覆舟龙耳竹策拨沙青乌子金锁秘示三仙五患当除彦辅清言玉函真梦二使一坏能制景纯奥语
农夫::父菑地利穑事陇前白首原上子播天时农功树下红颜郊行西畴饭牛荷锄种黍畎亩携笻荷蓑菜花火耕戴月力倦种稻田舍南亩饮犊负锸蒸梨耕云戴日戴笠稻穗水耨趁晴心勤浇瓜野蔬丰年乐牵牛去春带一犁惟知稼穑日日耕原上杖履身犹健风调劳鼓腹南亩茨梁稼化日长荷锸归秋成千亩不见干戈年年向陇头耕锄心未闲岁晚免攒眉东郊烟雨蓑场头防鼠雀浓露收新稻去裹一箪饭桑下弄儿孙迎寒葺草庐归收百把禾安坐慵耕游荡游手昼眠杯尽忘耕饱食安闲辍耕廪乏田荒自安痴心贪晚酒每废三时务不复营田陇饱食宁终日不治柔草满春山宁期百室盈多贪好市朝慵耕望有秋
樵夫::原野持斧斫薪刍荛运斤伐木穿林负重甜食晓日岩阿束薪挥斧斜迳木担岩边戴笠山林卖薪越岭临危饮泉晚烟斤斧荷笠息肩旧林芒鞋云际负薪斧担沽酒畏虎去去去时云随担敲叶雨两两登崖险斫柯寻晓去拨云寻古迳展歌喧绿野烂柯丁丁归处雨湿衣落花泥丁丁伐木声负重带星归踏雪下危峰往啸入幽林惊猿鹤梦采薪忧雪冷歌声松迳伴鹿麋游贪价愿天寒笛韵竹林间
牧童::烟蓑骑牛眠云笑歌曲迳携笠荷笠雨笠吹笛卧月归去荒村披蓑插鞭深村歌处烟中带雨篛笠牛背弄笛长林绿蓑拍肩芳草烟郊笑歌入画归时月下冲烟芒鞋树头调歌短笛青篛扣角碧川草地呼唤远近牵犊索骑牛去花边立红插山花犊驱幽迳晚弄轻风倦笛声高下问牛知子母东西饭牛歌吹笛归草上眠绿眠芳草笛弄清音夜眠明月归鞭影短长吹笛少宫商披蓑行陇畔暖日眠芳草鞭绳常在手戴笠冲烟去顶笠过滩头清风度远林蓑笠岂离身披蓑冒雨归
渔父::钓雪扣船鱼矶月明濯缨鼓枻钓浦水云孤蓬蓼渚柳岸泛波斜风观鴈脍鱼和月蓼穗湘江月浦短艇晚浦短笛枫江芦湾避世细雨亲鸥沽酒眠风芦花淮水雨蓬乱蓑沧洲半篙蛟室扣船双蓬鬓青篛笠杨柳岸一竿竹世尘远蒹葭浩荡蓑披残雪一笛蜃楼偎岸一钓蓑绿蓑衣荻芦洲万古名山雨晴风雨飘零钓拂红尘江山风致沉醉残阳里雨钓宜蓑笠灯火孤村夕披蓑临远月半艇鹭鸥热出没烟清闲歌古渡头烟吟称小舟芦花两岸秋张网近中洲一竿风雨清玉璜坐茅籊竿挂鲤射鸭白龙香钓把钓香饵撒网扁舟白浪投饵处珠泽倚柳笭箵引鲈钓鳌紫贝芳饵垂纶细纶乘舟轻篛金鳞放船归杨柳月高晓垂纶去数尺丝纶纶细时舒卷长竿横碧玉露栖平岸草曲树行菱角芦花风软暮踏月归一蓑烟雨矶闲任去来香饵掷黄金风约半池萍平池散茨盘飘衣风袅袅投饵水潺潺
打猎::臂鹰雕弓射雕驰逐旌旗走犬铺网分围逐兽飞鹰牵犬鸣镝落鴈畋游鼙鼓穿林结群齐射获禽走犬旗开金勒鹰犬去新丰市霜蹄滑声惊霹历雕盘平野鹘翻锦翅草枯鹰眼疾箭落角弓虎狼来细柳营帛羽高骑拥貔貅兔走横岗犬带金铃雪尽马蹄轻旗动将军鼓红旗开向日霜空飞二箭背手抽金镞此时随得兔弦鸣壮士弓白马逐迎风云影射双雕翻身控角弓他日不忘筌祝网骑马获麟放麑搜田黄犬作对旗旌捕逐云禽角鹰迅马驰千里开旗分小队臂鹰登峻岭纵猎苍鹰张旗击鼓奔驰霜兔羽箭高鹰起百重穿草合重围逐兔过平冈
商旅::四方寸心穷途天涯萍浮敝裘飘云关山客泪瘦马桂玉江湖通物万里千里逆旅地角蓬转羸马感慨歧路乡心孤舟萍蓬风雨出途为计贩贱食玉聚货蹑屦通财负戴乡信蓬转乡关殊方他山月非吾土言财当贵炊桂寓公担簦鬻货货财客愁萍流风雨故国故国衣是旧游年年客飘零客鴈外无书十年道路嵚山欹历落似水年光举日江山异恨随千里月处处家长短亭蛩边有梦万里乾坤险阻艰难如蓬身计驰情枕簟寒信断一枝梅闲思归去路衣湿全无火鸡声茅店月谋生空白发愁读寄来书囊空只有诗人迹板桥霜行路有青天乱舞颠狂卧草兀兀狂歌酩酊眠花醺醺幕天沉迷方酣日玉山颓随意眠芳草事业归浮蚁欲坐心无定举杯邀明月席地轻薄未醒时金盏尽无言对落芳功名等曲蜗将行步复斜白眼望青天
贫穷::尘甑四壁裂仓敝裘瓶罄知命茅屋穷途多疑病无余粟书千卷丹心磨尽弊衣一冠破屋长铗囊空乐天石田陋巷不疗贫乏一钱水一瓢白发染成瘦肌寒带粟玩月到清晓衰鬓数茎雪尘满莱芜甑病眼馁生花看云满太虚空囊一卷诗寒生季子衣
悲欢::涂抹纵乐禅语片时滑稽引观谑谈千古抹粉歌舞离合悲欢声如莺啭虽无三日笑滑稽惟取悦当场兴亡战争胜负体似燕翻聊有一时欢涂抹岂知羞
技艺::斲轮屠龙风斤雕楮画凤月斧轮奂效能应心秋月斧工夫巧斲轮非小技规矩施功食国黑丝绳事业新削鐻有神机
神仙::乌龙赤鲤悟真易骨交梨弄月服气换骨洗髓烟霞蟠龙鞭鸾壶天遐举琪树炼气养胎火枣餐霞炼形轻身伐毛云水石髓医凤蓬海飞升羽轮圣迹丹篆起石缩地种玉神符煮水服日元田修身啖松腴和六液炉中药仙灵黄庭成桥腾空化金宝箓烧丹冲天宝鼎养性服石髓醉百官国里书千年术蟠桃熟藏日月丹化米江月晓居紫府鼎中龙虎洞里有天飞符致雨一卷经碧海干煮山川枣如瓜海山秋乐丹丘松下龟蛇人间无路涂纸成金岛外烟霞冷玉兔山前药只应松上鹤金鼎消红日物外长年客残药沾鸡犬三峰千载客壶中日月长金鳌背上春便是洞中人丹田老紫芝人间一片云灵香出凤麟四海一闲人幽冥飞腾山灵依人忠魂英灵升降谈易阎浮主问地下事秘阁开金锁祸祸变化物怪瞰室义魄盛德屈伸修文地府神见土中人神人控玉蚪黑衣横巨剑人间留此像披发禀双眸天上作何星
僧::白足剃发虚空鸣钟苾刍龙象雪笠虎溪谈经缁衣出家清静飞锡真率葛藤云裾莲社说法觉性惠剑驯虎丛林咒水钖杖五门降龙琢句进步清梵煮茶八千偈法身戒珠咒龙丈室鸣钟沙门十善放鹤浣肠全身法灯洗钵三两弦布衣士青发改无碍律持界宿龙归钵归禅室瓶添涧水坐石云生袖花将色不染贝叶书白云间一禅床受斋归象踏山补衲衣袖挂松枝添泉月入铛必与水俱闲是山皆有寺晓风飘磬远挂锡云生树梵余林雪厚何处不为家暮雪入廊深烹茶日照泉罢岳钟残海月真觉了性入定洞云虚心无生悟空五蕴禅龛深机妙用了色相无非道明月心清虚成法性烟霞心与洁是非无挂念三乘龙藏妙旨玄功识皈依只此心青莲法解脱入空门水月性常明生死了忘机有修皆障碍清福人间少悟空诸念寂一真元不染去欲即攀缘红尘山外缘何佛一灯寒四大本来空一室法器麈尾说法三乘善根柱杖谈玄妙法悟彻经台天花坠五蕴真空万法庄严开卷喜先悟妙演三乘教学耸千寻岳楞悟通明谈坐神鬼钦三车奥义一音演说漱瓶知早寒精谈万法宗心含一丈冰岂辞开象教花从空外坠本欲振禅风龙就晚来听
长老::布袖静坐打坐不倦传灯身老金宝相时窥三昧绳床空谈罢参可尊老宿眼昏玉毫光圣出小乘老悟如来幻尘中人自老身心已无著玉堂三震鼓削发嫌刀冷犹怜舍利藏天际月常明乡党谩相猜对坐一炉香看经认字迟洁己修身面壁挂锡疏俗养性默坐常端坐清风益友履带阶前草逍遥安静室静守空门业心灰修禅无营看经焚香不出门明月相知衣无户外尘清净守空门安栖净室闲少知浮世士罕议市廛人瓦钵到处飞锡云笠削发芒鞋担经掷锡花迳出山衲衣游山洗盂雪鞋携瓢竹杖顶笠乘杯松林浮海辞家店宿看山三千界好行脚鹤啣锡寻穷天下青山绿水有时论日月持钵江行寻水四百州总法身龙听经看尽人间翠竹黄花随处卧烟霞远道擎空钵锡飞常近鹤片断云随体锡飞三楚月占树迷芳草乘杯超觉海名山踏落花杯度不惊鸥稀疏雪在头身卧五湖云残经锁白云振锡出尘氛
道士::紫府丹台鹤发羽衣焚修清净仙林岛外仙风胎息孤云金鼎黄庭药灶星冠仙箓冲炼焚香洞府壶中道骨坐忘野鹤玉池种玉神剑悬壶交梨神清竹屋孤鹤六甲乐道古柏星冠卖药泉壑烧丹醮坛种药火枣眸朗松坛双凫五雷休粮仙坛霞帔吹箫石坛天星冷依药灶脚踏雷车饮残甘露囊中仙诰鼎烹白石千章隐篆烟霞三岛客山鬼悲护丹田手持斗柄炼就还丹袖里天书符入青霄一曲空歌风月一林秋洞中留白石诗无入俗句日月悬壶里鹤老谁知岁窗下写丹书箧有化丹方河山挂杖前松寒未作花风雨敲推涤肠金经采药乾坤吟怀囊有锦骨格棱棱山亭访竹静坐云生石嘉遯终相与琢句彩笔题诗风月行脚镜无台诗名秩秩野迳寻梅狂吟月满窗清言独未休云霞虽异色江海本同流云封鹤唳行迹锡飞采芝去末回去锡未收挂衲烟锁猿惊履痕扉掩望鹤归有读残经仍有残不逢花雨雨消石洞问客来何处云外未归锡过山随虎迹野客独登阁苔封古碑没怅望翠屏云锁禅关云僧出未归松间觅旧题倚石听猿啼寒云空满山竹引细泉通孤云人世草履三岛独鹤仙山麻衣五湖携琴瘦笻石壁去程辞世骑一虎骑只鹤东西影放丹寻野水手携绿玉杖引鹤野鹤洞天归路负桐佩双龙解双凫去住心采药过幽林头戴白纶巾山中春雨过心随流水去清泉磨宝剑水上落花多身与白云闲盘石鼓瑶琴云洞松阴凫鸟舞鹤仙坛山色云裾啼猿采芝鴈先去云碓静苍藓合题姓字药灶烟消石迳萦纡竹窗留鹤守云封丹灶冷拂石鹤未归石砰闲白云制隔云霞松关雨歇洞门岑寂丹灶倩云封日照石秤空药圃花香异泉沙鹿迹新
尼姑::金刀持戒佛性经卷舍宅题壁落发持戒苦不求陪客话玉体焚香禅心药炉立碑赠诗存心步莲迟应恐坏禅心唤起犹侵晓催斋已过时行道吹箫金丹乘龙骑凤绝粒金丹辞金屋不惭弄玉步蓬击磬锦字驾鹤驾龙步虚紫府向雪峰应学嫦娥
才女::受业解围辨弦续史记室置幕椒花颂林下风深明闺阃理味絮属文大家辨柳絮才闺中秀洞识古人情化石投环守节采桑筑城断臂啣哀冰心烈行柏舟劲节金石沉湘挂柱握符截发剔目卫姑誓死霜操贞心彤管英魂冰霜心不改神明鉴乾坤老玉碎珠沉地老天荒皓齿终不发白发冰霜共节难移天地知草木香山飞海立海枯石烂芳心空自持丹心铁石如
美人::国色疗饥含贝云鬓楚娃曲肩仙姿倾国凝脂风鬟宋艳丰颊檀口皓齿玉颈蕙心舞衣云髻蛾眉倾城窈窕一笑红宝髻清歌雪肌、黛眉朱唇兰质歌扇花颜蝉鬓绝代妖娆千金绿鬓罗裙妙舞时样绛唇如桃叶知腰细胸前瑞雪双眸剪秋水脸比桃犹嫩姑山半峰雪新红脸似柳枝觉指纤眼底桃花十指露春葱肌嫌玉未香瑶水一枝莲动衣香满路柳眉横远岫移步袜生尘星眼动秋波
贫女::荆钗蓬鬓守节夜绩掩面布被布裳固穷分光闭门木栉握金线蝉鬓懒梳照面盆为镜机梭常彻夜貌美烟中玉固穷且德耀瓦瓶泉自汲布裙学画眉蛾眉羞照梳头水作油布絮不知春情幽石上兰种德待梁鸿茅屋灶常寒
妓女::朝云暮雨送旧飞絮当炉清歌袅娜娉婷翠蛾翠袖玉笋脸下行雨仙袂娇体态迎新落花送酒妙舞轻盈窈窕丹脸罗裙金莲眉头驻云歌声假心肠桃花脸春如海神清素管弦楼上翠袖长垂欢生锦帐红酣春色眉欺杨柳叶柳叶眉夜似年步轻盈罗绮丛中罗裙轻衬梦入阳台翠锁朝烟裙妒石榴花洒落千年调溶溶春似海樱桃樊素口金扣含羞解清新一曲声缓缓夜如年杨柳小蛮腰银灯带笑吹
宫怨::题红望幸旧恨深宫长门玉簟贫赋承恩新愁薄命静夜珠帘翠辇思幸愁欹枕花雨冷恨题红叶愁看蝴蝶羊车感恩懒画眉叶云香愁上翠蛾懒绣凤凰画阁纱窗心闲御罗绣针彩线意懒宫锦玉指徙倚日长频眉春心乱愁眉结愁先结针头不解自别蒿砧后泪频垂玉筋金针徘徊春园隐几午梦长泪脸珠恨亦添线缕难穿懒将针线穿线懒度金针听得莺声巧懒将针线拈
忧愁::鬓乱酒困无言浅淡蓬首羞拂黛眉不扫玉肌自瘦愁蹙柳眉钗斜睡余有恨鬅松残顝施朱鬓慵梳红粉未匀泪融莲脸蛾眉应懒画粉黛无心理不欣盘凤髻蝉鬓不曾梳衣襟频泪沾无意画蛾眉
怀念::锦字同心鱼书白练金刀误封红笺封泪鴈字齐纨玉杵和泪边霜音信断聊达意数行泪杨花无定宝毂香轮肠断剪声夜长灯影灭蝉鬓凋将尽塞月梦魂惊杳无踪千里心海燕有情峡云巫雨泪多线脚天远鴈声孤虬髯黑在无
奴婢::苍头臧获爱才奴星门干长须老妪鼓枻笼鸟捧钓鹰犬才赤脚舆台覆毒海使家僮无齿健儿采薪风花吹箎牛马走收纶钓报知鸥鹿笼鸟无常主鸳鸯拂瓦去煮茗茶整顿琴山风花不恋枝鹦鹉透笼飞
勤学::焚膏囊萤磨针下帷潜心尝胆舌耕竞辰黄卷随月读十年窗下业漂麦凿壁警枕映雪笃志引锥笔耨继晷青灯带经锄万卷腹中书休嗤五经笥味道心千古道究天人奥竟日闭孙户方对圣贤语全胜一籯金披文目五行言探圣哲深无心窥董园全无车马喧
劝学::萤窗蚁诚雪案豹变诗书黑发不勤简编韩氏火王侯宁有种喜对圣贤语白日莫闲过功业白头方悔诗礼伯鱼庭将相本无门羞沾牛马襟青春不再来
博学::陆厨渔猎边笥枕籍三箧觅句书淫博古五总龟惜三余衍秘书考定五经有余才智学富五车五车抄书学富尊经九经库穷六籍精史学渔猎百氏明习献章胸罗八斗宏览天人尽入网罗学储二酉骥足轻千里积学三冬富总龟腾美誉博踪邱索任从操括道通八家鸡窗满五车撑肠万卷余武库播芳声
读书::闭户万卷汲汲藜火展卷披卷时习克私夜诵图书沉涵兰室寸阴下帷百回孜孜笔花焚膏斫思日新察理晨吟灯火讲贯芝窗千古窗前草五经笥新得妙睹功名儒志苦无穷生意内蕴多文岂为功名心常潜大业架上书三月檠旧通融对圣贤圣门高不了工夫旁通万物只尊道义手不释群经锐意论诗礼休辞连夜读诗书资博约指日三冬足汗简留神久留神究典坟也胜带经锄礼乐致中和存心万古情青藜照诵初黄卷赤轴汗简史籍九经断简五经蠹鱼五车鼓吹羽翼亥豕石渠弥天地明治乱漆书经书万卷残编三史蝌蚪四库讲明笙簧鲁鱼白虎贯斗牛见安危秦灰尽贤从此学至教遗千载优冠四民贵诗逸篇何逸古字传蝌蚪度日一编鲁壁存贵向斯求微言播六经精通六艺功书焚道未焚新编剔蠹鱼怀人千载前未见微言多闻广见阅市奥篇潜窥求闻一诺方希路氏知君富有编蒲隐帙急读假馆四痴莫学王充愧我空虚五车插架缥囊书府四部垂签缃帙儒林竹简千金邺架俱收遗编收藏芸叶学海盈庭发箧蠹鱼钿轴异书牙签万卷曹仓并蓄秘阁积厌墨庄书厨满架开厨蝌蚪山芸奇字家藏篇章先后次堆几惟编简家藏千卷富横几铺芸帙素纨无暗色专房一竹几手校篆隶古今形攻文如蠹鱼身得一生闲褰帘放日光芸草有余香列屋万牙签篇章牙签翻经风揭褰帘晒卷无余润日映龙蛇动雪楮随风卷风生安世箧简帙蠹简散帙日烘隐几观芸有夜香风飘简帙横仙芸趁日香日射郝隆庭香敷芸叶润书久蠹鱼穿数幅开续海角一函蜡丸鴈翼未见面无鴈处经年相思天涯千里邮置鱼鳞已慰心有书来两行灯下泪鴈卷三秋字家信传千里尺书无寄处雕虫蒙记忆一纸岭南书鱼沉一纸书芳牋灿五云中夜不眠时烹鲤问沉绵
文章::锦心有神辞锋典雅笔锋文思雄健珠玑韩潮琢句绣口无敌笔刀纵横谈阵笔花风流圭璧苏海为章日光正声扛鼎拔地立句冲霁色才越俗穿天心举日月一家机杼翰乌坠云玉洁劲气驱涛涌云高才驾云涛秀横秋出月胁缚麒麟万斛泉源流星超海笔下宫商毫端风雨夙有凌云笔礼乐纵横序百川倾学海自有波澜势胸中斧藻纸上云烟方乘犯斗槎诗书典雅文三峡倒词源全无斧凿痕
赋::神速三都绝奇五色纸贵吐凤抽黄芳腴日五色乍有凌云气吐凤才无敌词章春藻丽未羡八叉手金声雕龙对白藻缋手八叉时闻掷地声雕虫思有余声律古诗流何须十载功
诗::狂吟六朝金玉骚章清新笔阵铿锵元无俗藏今古元白垒珠玑唾醉墨四始波澜丽句隽逸诗坛挥洒本自清泣鬼神李杜坛锦绣肠三千首词藻富笔倒三江水五七字中苦山川千古气至质翻如鲤四百洲墨花香诗专五字城百千诗后清风月一时清尤瞿始是仙一家三复铿金句句锦绣清新阳春骇目高吟楚骚蕴藉元刘二陆幽栖志翔丹凤戛玉篇篇冰霜高雅白雪惊心寡和陶艳珠玑陶谢三刘寡和章现玉虬无人敌开编见千镒贵从今独步旧闻姓字白雪不容和一字含风雅数篇吟可老举世降闭户知万钧轻谁可同流今见文章清风空畅传十篇费琢磨七字妙堪贫与观纸上咏眼前飞白雪如对座中谈纸上布阳春苦吟搜奇访鹤纵吟泣鬼有神夜吟鬼神哭遣兴得句骑驴排闷惊神无敌苦咏星斗寒工夫进李百篇飘洒风烟密移造化染云作句搜疑沧海竭吟成七个字一句坐中得滋味长杜千首剪裁花草细织云霞镂水生花得恐鬼神惊撚断数茎须片心天外来兴吟梅下月若非观外物岂有诗名世醉卧柳边风安得动搜冥而无鬼作穷
仕宦::银帐棍蝨昆鸟化瓜期五斗入仕捷径鱼饵鱼带报国斗升印累累朱袍网虫鹏程锥颖一囊拘人旅亭马啣蝉联忧时符牒绶若若头童齿豁鱼缀白金昆鸟鹏变化利禄蜗涎壁心虽如笔正鬓雪人间寿未换银青绶婢膝奴颜鹊啣红绶鸾鹤程途年华蚁梦槐官不称才高腰金世上荣惟添雪白头巧宦多成拙孰为真汉相仁义大捷径徐行未必迟却忆假齐王诗书一旅亭
显贵::玉带致笏通籍十轮画戟貂蝉金鱼鸣珂垂组万石朱门鱼带亨衢鼓角列戟华毂黄扉海市马如龙神仙府新筑沙堤籍通上界锦骑朝随猎要路笙歌吹笙朱轮紫阁冰山车似水将相家始分茅土身侍甘泉金莲夜赋诗御鞍金腰褭人间真富贵老觉腰金重官砚玉蟾蜍座上艳神仙慵安枕玉凉
门第::名阀华冑衣冠高门家声三朝世卿名家柱石累叶世禄累世阀阅习仪家贵盛王公门谙旧事华冑蹑高位赫赫钧枢后的无金遗子有子皆黄甲勋劳继美国盛衰社稷臣习朝仪豪杰沉下寮堂堂节义门仅有笏传家满门无白丁
遭遇::鱼水结袜攀鳞前席攀龙凌云笔歌短褐攀桂上一言寤冯唐老龙云弹冠附骥同车附凤犯斗槎请长缨踏花归万户侯宁戚歌寄股肱熊飞清渭蛟龙得云雨一言能寤主零落沟中断贾生前席待垂竹帛龙卧南阳雕鸮在秋天万户觅封侯酸嘶爨下音吕望后车驰
名誉::北斗泰山金城威名开泰鸣鹤韩范虎变执牛耳斗南人天下闻时轻重声名飞动敌国英誉书名景星萧曹龙翔夺龙头天下士野老知国安危翰墨流传凤凰文德山河著誓水府珠光见竹帛铭功草木知名丰城剑自辉
名利::名钩蜗角旧尘世味红尘蝇头虚名黄金无昼夜废寝忘食利中计较利锁鸿毛蓼虫人情青史骥足微利茜绶历风霜登危涉险名上工夫半身利路蜗角虚名小世味刀头密宦情蕉叶鹿红尘蝇竞血门外红尘客相争两蜗角一钩名饵鸿毛俗虑轻人生水上萍世味蓼心虫青史鬼争名城中白日闲所得一鸿毛
放逐::去国三黜逐客泽畔书空天祐天谴鬼门谋身拙身轻似叶事可语人投荒孤忠骚人海隅抱恨生还鬼谋泽畔报国危名重于山面无惭色愁看北渚力犯雷霆落叶独归鸟生涯投岭徼草色无征路得罪风霜苦青山数行泪恶说南风远投魑魅孤舟何处人世业陷边尘莺声傍逐臣金生天地仁沧海一穷鳞江岛同三黜天涯酒一樽
退休::致事解印焚章晚节命驾鸥盟绿野自由闲居投簪悬车挂冠税驾归休赋归鱼钓东山真乐高卧招隐归家拂衣得策称好好黄鹄举真天爵青竹杖早避喧烦七不堪中伏枥老归结社垂钩收功赋休休白鸥盟即地仙白纶巾未逢荣辱三宜休外白云闲钓书留儿读早到林泉未满求先退退想裴公野避贤初罢相田为鹤谋今抛簪绶归闲不厌贫归思范蠡舟乐圣乃啣杯
宠爱::甘棠制碑传德桐乡立颂载功攀辕怀树鬻衣生祠修湖植桑筑堤借寇去思画像堕泪碑看碑堕泪拥马立祠致奠野哭罢市留犊卧辙留侯遗爱敬神下马陵卧辙攀辕死有奉祀举辕情久驻碑已无文字愿借寇恂一帝为制碑截镫泪频垂人犹敬子孙重留侯霸期
志气::弃悬旌题柱乘风乘车破浪雄飞手掬四冥澄清有志声摇山岳动投笔击楫出关隐雾揽辔钓鳌高卧气吞八极洒扫无心气贯斗牛寒气冲看匣剑肝胆一古剑勋业频看镜司马空题柱颖脱抚囊锥波涛两浮萍行藏独倚楼终军敢弃??
气量::厚德镇浮广大宽容宏襟扩宇汪洋涵蓄千寻海望高山斗风月胸中气摩霄汉矫矫云中鹤爽气金天豁万顷波度扩沧溟山河掌上手摘星辰赳赳天半霞清谈玉露繁
豪放::谈锋壮怀气概豪气湖海醉舞放浪凌云劲才得意诗句健醉袖舞诗笔健天地窄形因诗瘦鲲鹏狂歌昂藏捉月英气忘怀酒杯深诗情狂酒钱麤海山平眉为酒开屹存砥柱星辉月朗驴背倒骑唾视冰山壁立澜回牛腰稳步
豪侈::烹龙锦帐金兽绣勒珠帘金丸金驭炰凤罗帏玉箫金鞍彩树玉轴翠袖浆酒金埒翡翠铁马银鞍青障珠翠煖珠错落莹韬宝鞘红珠斗帐玉凤啣铃珍馐银山金莲金鱼绣鞯紫箫管弦高玉雕锼骄爵金衔金尾屏风金龙吐旆连钱嚼金勒绣鞯金匼匝马头金匼匝凿落泻银罂貂袖紫蒙茸驼背锦糢糊
聪慧::纵横思敏刻烛五行脱腕摇毫敏赡才豪挥毫七步涌泉掷简吞篆百纸今古少疑宿构五行并下左方右圆敏捷诗千首笔下龙蛇走凿心万言世间奇立成章三步成文目览手答飘零酒一杯胸中锦绣成
豁达::乐天修洁鹏鷃卷舒山林溪山与世周旋白云舒卷知命退恬鱼龙出处风月诗酒随时忧乐浮世兴衰道义并山重富贵人间梦形骸俱梦蝶浮云观富贵百年都付梦功名草芥轻功名海上鸥名利两亡羊枯木等形骸一笑总忘形
知音::青萍投璧操瑟青眼按剑焦桐珠暗投骥长鸣白璧绝弦负草朱弦挥斤垩鼻弦终绝璞三献燕昭怜马剑鲜初鸣匣豪贵少青眼不顾钟子耳瘦马识騄駬黄尘多白眼赤心遭白眼支遁爱鹰刀呈一割铅文章多白头谁识伯牙心枯桐得云和碧玉绝朱弦笑面得嗔拳鸥舞蓍龟易见鸿飞燕雀焉知曲突徙薪受恩先退秋风思脍得意好休
警戒::兢兢刺舌履薄业业炙眉临深鱼吞饵念射钩鱼烂缘吞饵蛾扑灯长佩韦蛾燋为扑灯乞怜解围舞剑御侮徒哭辙鱼精卫思填海排难脱急抚笔解纷同舟阱虎包胥远哭秦
滑稽::抵掌凭轼霏眉雄辩纵横掉舌诙谐多智悬河绝缨涌泉高谈浩汗解颐谈笑无穷玩世辩论唇舌如云群听耸学富千人敌诡时绮谈波澜注水四筵惊谈高四座倾
仰慕::披云景星希骥识面芝眉叩斗祥风效颦卜邻陂量刮目春树泰山希颜叩郸步识面为荣旧闻姓字若瞻韩愈金石风流茂叔襟怀倾心暮云北斗御李折角巾不衣自暖今见文章不见知章蓬壶云气紫芝眉宇李邕求识面蜀天何处尽将期一诺重磊落千人杰王翰愿卜邻巴月几回穹剡便寸心倾生存九庙灵
称誉::推挽金谐鸾凤观国吹嘘鹗尽麒麟凌云令威德性文章朱张列千人敌得季布千年道统堂堂笔阵容质谦和天上张公子骥子高风德业韩柳问四座惊说项斯一代英雄滚滚谈锋文章典雅云间陆士龙骅骝开道路鹰隼出风尘
不得志::叩角枥骥屠龙惊鹊连蹇书空钓渭虎为鼠歌伏枥击壶月乌失马困鳞躇一弹铗耕莘蛇作龙赋枯鱼违人意甘袖手无奇策惊鸟绕月书中岁月高才人忌歛熰历落壶歌怜枥马与世疏且啣杯屈壮图嬴骥斯风镜功名车道拱疏险阻艰难瓮舞笑醢鸡壮志初题柱霄汉愁高鸟未能探虎穴生涯独转蓬泥沙困老龙莫作饭牛歌
报恩::埋蛇扶轮绣被蛇珠执炙吞炭渡蚁结草铜钩龟印绝缨捐躯盗马破敌苏涸辙知己而死已容冯驩舍触槐御徒困监车活人必兴犹伤范叔袍
怀古::今古江山望远流水争战空梦国家江树头人何在千年恨成何事兴亡豪杰伤尧夕阳英雄断碑禾黍楚云哀潮自来一世雄半落晖千宫冢吾辈老广武叹河声灰膏肉伤往事汉家钟鼓天荒地老事往千年百代官古人林洛生吟野色中动心魂枕寒流魏国山河虎战龙争愁来一日词客有灵江水淮山江山有恨流年川暗度园荒乔木盛浮云多改变北望人何在霸才无主宋台梁馆天地无情往事月空明堂在昔人非乔木几兴亡东流水不回
感慨::感时心折揽镜Q 思恨愁容往事昼梦白头落日存殁白塔动归兴恨别骨惊闻砧飘零归兴流年晚愁青鬓断霞古今荒城感中年难成醉年年恨心欲折人情似纸楚客登临可以语人寝园寂寞拭泪沾襟血易断魂日日生鬓未明世事如棋谢公哀乐不如意事行殿荒凉梳头满面丝冻鹤连岩雪烽火苍茫外苦调琴先觉感时花溅泪愁人半夜砧江山感慨中愁客镜独如恨别鸟惊心
闲适::雅趣步履花迳风月高情携笻水村江山琴书琴随畅酒垂帘坐久花日吟笔开轩歌枕数落花诗分匙僻得意诗长好诗酒鹤伴高眠把钓归迟松风醉茵灌竹看云寻芳草棋下子迟逢时酒不虚苔迳闲搜句雅趣钱神外青山扪蝨坐树浮青嶂出拂簟承花落茅簷坐看山高情酒圣中黄鸟枕书眠江带白云流开帘待燕归
怀归::归心孤云望眼落日长路登高千里客心异地归兴故乡离恨登楼作赋极目蝴蝶梦家千里他乡望远一年归梦故园诗愁旅梦旅怀流涕闻笳奋怀子规声鬓二毛孤云远清夜梦愁寂寞寒日暮月初上天欲晓千里关山双鬓客心枕中故国一鴈飞白头吟信微茫故山秋人未归泪空频一番风雨两眉乡思镜流年风霜侵晚节雪声遍傍竹解组辞骢马露从今夜白老侵长路鬓湖海三千客倦游行老矣天地入归心寒梦不离家还家卧白云月傍故乡明春荡故园心妻孥四壁居不隐赋归哉
夜宴::暗花银烛更深翠幕秉烛绝歌酒令凤烛红蜡绮罗酒樽风生席明月金樽酒尽绮筵传杯妙舞诗筹蛾眉青坛灯烛星斗月满楼排银烛更漏促笙歌沸主人投辖杯浮细浪令罚抗歌银竹树前银龙啣烛影树玉山管弦清锦绮明痴客绝缨灯结繁花诗成醉骂露桃花下金凤起炉烟巨觥欣举白检书烧烛短玉容歌白雪有欢常尽量富贵春无限尽烛受深红看佛引杯长红烛照朱衣不醉亦无归欢娱夜未央对影饮酒作诗吟诗吊影寒光素海露凉清风对月刘伶醉金镜玉壶风传鼓角临风整环佩无尘爽气金波月冷明月衔杯李白歌碧天银漏云卷笙歌邀月入金樽镜光浮素魄月凉衣有露素光寒眇眇杯影泻金波风静座无尘高兴夜漫漫挈榼檀耳五斗一石瓮下留佩提壶酒泉千杯千钴墟边辞沼杜瓮奋髯翔车觉沈带酒功圣槐河枕枕曲携壶操卮投辖露颓洗杓倾浓玉阮兵腐加田钱后寓酒樽醉卿宽竹叶杯藉杯荷插倾玉执觚流涎啣杯吸怒潮身外唯须醉放歌悲世隘五斗助吟兴脯歠临糟瓦人间不足愁长啸寄天游千盅入醉乡流涎见曲车
醉::千日幕天倒载醉渴心百壶席地狂歌梦中醉眼垆中倒金斝酒岂辞金斝汨醉把青荷叶醉客从为客把盏防贪醉瓮下眠玉山颓那恰玉山颓狂遭白接曰离诗成觉有成摊书作饮筹孤国无伴自饮忘言一壶自酌兀兀自把壶觞悠然一斗春光生两胁五斗人忙陶陶独怜酣饮美矣三杯月影照孤樽
寝::曲肱黑甜抛书局卧便腹黄嬭寻梦困眠鸣雷黾息高枕梦蕉酒浓春醒日当午半帘晴日青奴初荐枕尼父肱初曲梦蝶雷鸣歌眠讼鹿睡美午梦梦正甜一枕清风黄嬭亦井堂边韶腹正便烟袅金炉翠北鴈风清处竹鸡啼正午帘垂花院深南柯梦熟时蝴蝶梦初甜曲肱黑甜抛书局卧便腹黄嬭寻梦困眠鸣雷黾息高枕梦蕉酒浓春醒日当午半帘晴日青奴初荐枕尼父肱初曲梦蝶雷鸣歌眠讼鹿睡美午梦梦正甜一枕清风黄嬭亦井堂边韶腹正便烟袅金炉翠北鴈风清处竹鸡啼正午帘垂花院深南柯梦熟时蝴蝶梦初甜
梦::冰上斋中漏尽生松南柯华胥室南枕上魂交落鸟春草槐国蝴蝶蝶化栩栩晴窗忘形笔授江淹忘形空栩栩魂散三千里一枕魂初散熊罴神交蘧蘧午梦适意草生灵运适志正悠悠神交八百秋三竿影尚侵槐市三竿日依稀闻漏尽化为漆园史鸡鸣频唤舞荷亭一枕风仿佛已神交飞入大槐宫蝶梦不成庄
行乐::花村名园载酒游山步屧雕车拂石寻花竹间频驻马垂鞭袖莲荡胜日踏青玩水携笻玉勒蹈花看月物外细吟诗弄笛船携诗卷纵横联句十里青山熟寻云水行携桃杖山堪布屐无处不宜酒胜概烟尘外把酒杯次第看花半篙春水饱听笙歌归袅竹鞭水已胜舟有朋方解颜新诗杖履间偶随流水去澹与暮云还
寻访::扶笻过花穷幽步屧溪桥芳草笻跋载酒穿花青帘移席穿柳选胜吟鞭野店垂杨篮舆携朋渡水朱槛投辖远林路长布屐静爱竹携笻渡临乱石行不尽芳草路难尽杏园香扑扑拟轮小圃溪边杖藜独寻春信笔题觅群芳步还迷绿杨村更深柳陌絮纷纷鸟语娇迎客人逐轮蹄去对酒去无语花容笑引人春从巾杖来磨崖细有文
踏青::载酒水曲选胜蜂蝶策马外行吟山河闲游燕莺寻芳桥边缓步香车珠翠绣屐步步罗绮屐齿临流松下纵赏金堤上落花天红随辔醉眠游骑芳菲画桥行行壶觞车轮藉草谷中高歌碧水边芳草地碧绕轮皆有艳宜斗草三五来风淡淡马嘶垂柳夹路好花细数落花花落帽簷马蹄穷翠径尽开花好飞觞纵横醉草芊芊鸟在疏花临皋仙佩缓寻芳草草侵屐齿酒旆指前村慢寻花发处步迷芳草径翩翻红旆翠花光随雨霁立马千山暮已过絮飞时车驻绿柳阴闪烁画桥新草色共烟深回舟一水香
斗草::撷翠香郊盈襜幽馆莲步群英赌胜步香名园庭院寻嫩绿萦玉笋光侵客履一径岚光品多因赌胜莎茵百草争奇拾翠芳径郊原赏芳樽赌金钗色逼人衣满郊烟翠香满觉清浓好把芳名数酒含杯面绿竟向幽堤采色映茵舖草懒将嫩绿排衣惹坐中香争从曲径寻光连莲步人
避暑::脱巾纨扇口枕调冰竹林露顶纱巾籐床切藕松径披襟亭台松花江风沉李幽兴碧瓜枕石桑落酒冰盘果都无暑炎暑去散发松竹水酪溪雨浮瓜繁阴纹簟漱泉玉池冰水殿风却有秋晚凉生几竿新竹吟增好兴茂林修竹绿竹挂衣摇扇腕愁脱井好能冰齿玉骨冰肌外一枕清风涤尽烦襟白石清泉清风展簟沾裳汗似淋茶甘不上眉纱厨竹簟中北局清风足竹深留客处襟怀霜六月西山爽气多荷净纳凉时枕簟雨三更
出行::晓鸡残漏辔湿宿鸟漏急月明寒角疏钟衣单邻鸡更残霜清寺钟带星客路孤犬疏星寒犬曙风矮僮烟寺茅店寒露银漏促鸡催晓城角乘月行装蹇驴落月荒鸡晓雾瘦马渔村山城冷云玉绳低雁唤秋石店露几处初钟断露湿征衣重陇云归雁断关山半窗月鸡声茅店月野鸟时鸣灭马蹄霜半桥残月明霜霑短镫寒关树晓鸡鸣风雨一声鸡人迹板桥霜残星似有无断崖奇峰松门前途好景虎迹峻蹊曲折蹬滑野鸟石磴千峰绝壁叠嶂石路峻岭寒驴樵声崇岭跻攀山幽山花云林万木莓苔水远茅门瘦马红日蒿台疑无路诗句惊磴滑啼猿曙承屐齿烟溪暗木落霞明草迳短僮白云石室别有山画图间怯山幽古桂秋濯缨尘云岭寒山掩映苍山解事一迳蜿蜒千章秀木山花有意岩花点寒溜危峰蟠鸟道溪云常带雨路崎岖好鸟迎人两山苍翠一点飞云野鸟留人石磴扫春云深谷富猿声山木自含风林深山鬼啸白含云窦雪未知真是岳崖古蛰龙蟠青补石门天祗见半为云
郊外::小径杖履携笻苔迳牧唱草迳野路前村郊原临水枫林樵歌烟郊江村竹杖幅巾长堤野意沙禽草短草村修竹禾黍疏畦千百亩萝阴合情更逸芒鞋藜杖幽草岚光野菊麦深涧水怪松牛羊籐架两三家麦穗齐兴何长鸣坠叶荷半卷沿崖上十里烟霞烟横碧树雨入荒畦暗草薰苔迳气味闲中好宿寒鸿竹全疏靠岸行两崖禾黍草带金沙风来叶岸青杨扫石矶风烟野外佳村向遥峰出独立乾坤大行到水穷处听莺红杏曲溪明返照侵徐行杖履轻坐看云起时驻马绿杨阴
江边::暮雨举棹野猿潮声客帆维舟江鸟月色白苹夜泊落雁远波极浦岸头岸花云山长堤孤蓬双蓬鬓旧宿雁红蓼秋征栖禽轻浪前林船背沙鸟潮市远树满棹一钓舟起眠鸥溪上石一笛西风翠竹白沙长风送客水近嘘寒气漠漠帆来重野旷天低树渡头风满船行客黄鱼紫蟹积雨浮舟星残曳白芒冥冥鸟去迟江清月近人山远疑无树数声疑岸橹万木千山路藻密行舟涩潮平似不流几点别州山孤舟尽日程湾多转楫频
雪景::骑驴耸眉短僮灞水策杖拥鼻瘦马蓝关前村林麓琼就羊角飘飘转昏埃埋故驿锦飞千柳絮冻袖新诗句别浦峰峦玉削成鹅毛片片轻积雪缟修途羽化万银杯寒林古画图
傍晚::整履乘兴策笻纳凉玩月涧畔杖履眺望夕阳归鸿杖藜村路落日鸦投宿犬吠竹篱茅屋上斜照乘风林边衣襟吟哦暮霭落雁赏月柴门幽林萤曳光鹤随苔岸水烟生暮寒平沙一雁落风前灯易灭搔头悲短策泼泼莓苔迹放怀当晚景古木乱鸦栖川上月难留适意步青芜移移草木阴纵步过幽林
春望::晴云江山暖日桃李陌上柳色画图云霞浅紫水光倚栏风日弱柳艳红朱槛桃花花暗城边花香诗句罗绮深红山色纵目楼台好花浓绛碧林柳叶鸥驯家家柳红锦黯篱落厚水嫩绿乾坤醉宜图画芳菲地花似雪红笛起远水连云处处山绿罗新桔槔低花新红世界浮似管弦落花村草如烟岛花飞暖风催绿花折艳红落花无语野店归山路芳草碧千里水暖春光外天远水云淡晴川乱柳色草铺浓绿芳草有情危桥带郭村夕阳红半楼山明落照边春深花柳妍夜雨涨溪痕草平天一色烟姿浓淡处风暖燕双飞山色有无中
远望::归云一雁蝉声黄叶禾黍携笻极目碧山落日千山秋色白云郊原信步倚楼红树新霜黄云枫叶园林蛩声牧笛红橘柚篱菊静禾半熟群鸦乱噪鹤盘远势薄晚绣树雁行芦荻雁影归舟老蒹葭渚莲愁雨初收一鹗狂飞蝉曳残声虫鸣短草霜寒溪水瘦残阳初过雨黄叶溪边地乾坤秋满眼稼穑铺千里鸟破孤烟天远野云痴何树不鸣蝉青莎雨外村岁月晚惊心烟霞散万重木落梅开极目稼穑残云黄云野梅岸梅凭几雁声过丹青树金包世界云散远山凝望山川北风白草陇麦畦麦倚楼梅信来水墨香玉削楼台池成明月云卷四山雪水声冰下响琼楼增望眼宿哺人迷径落雁远沙渚樵人归白屋风凝千树霜沙路雪中平玉字快吟诗归林鸟失巢饥鹰噪野田寒日下危林登楼月淡卷帘残角远望宿雾轻烟星河落雁横塞烟笼高岸几点残星倚槛星疏极目晓钟闲吟归鸦薄雾晓色分人倚楼霞罩远峰数声啼鸟风霜严塞草碧知湖外草木杪星犹落星月淡秋天红见海东云城头月渐低极目晴后水练霁色山色芳草云山野水摇光练平山行诘曲凝眸望中山屏晴岚水光遥山风竹遥山列画屏小径夹葱青春莺鸣古寺烟草入平村虹收远水征帆云敛遥岑去鸟云水吟情天色江乡翠霭倚栏明霞立鹭残日波光断虹野色斜雁风烟眼界水光烟渚斜阳卷帘远岫来鸿断云云影孤鸟溪光晴虹岚气烟消林光新蒲霁云山隐隐虹影外水拖长练半山落日悠悠烟浪秋光云破溪色细柳雨浪水粼粼霓光中山出画图别浦轻烟叠叠云山薜荔雨除虹收千嶂雨静听波声急数点渔灯小水涵天影阔风转云头歛泥途无客滞蒹葭烟尽潮散半江天遥观山色多一钩帘月弯山接地形高烟消水面开绿野有人耕上下皆图画乾坤一镜奁
晚眺::落照暮霞归舟瞑色返照远日断霞归鸟倦鸟秋光归云平芜孤霞斜阳新雁倦鸟新月残照野火孤城暮钟云山灯光秋月上眠犊晚落月翠霭残阳归鸦落霞余霞渔灯远望残角风月芦花夕禽还去鸟寒日沉角供野望孤城暮烟光薄返照入江云外垂虹水浮落日树藏秋色老疏钟吟落照风满楼快人心远树明瞑色深归云拥树日边归鸟山碍行云禽带夕阳归归路指平芜牛羊归径险天地浮元气海气升孤月野船明细火鸟鹘聚枝深山河散夕阳岩姿起瞑烟宿雁聚圆沙
祝寿::龟龄称觞佳气诗酒佳辰南极霞觞尊黄发乾坤异三洗髓蟠桃开日鹤筭祝寿欢声笙歌诞节长庚桃实续紫芝日月长满添筹古柏参天秀似灵芝仙药宁无种宜佩长生箓但祝无期寿祇缘仁者寿清如寒露灵椿别有根应为不老仙唯焚不断香宜尔炽而昌
祝贺::合卺喜气结褵懽声佳遇楚岫凤枕琴瑟朱陈神女琼玉牛郎吹箫女鸳并立鸳鸯带山海固新欢阳台鸳衾鸳鸯秦晋仙郎松梦织女傅粉郎凤同栖孔雀屏地天长三千朱履鱼水欢情巫峡行云五夜芝兰十二金钗熊罴吉梦武陵流水百佃瓜瓞梦熊悬铃梦罴老蚌食牛赠鲤投燕集凤明珠跨灶桑弧麟儿喜气焚香对客贵骨头骨肌骨彩凤金缾水汤饼客瑚琏器蓬矢骥子欢声祝寿宜男啼声掌珠精神石麟襁褓香弄璋书栋梁材麒麟子蟠桃结实千里龙驹秀兰生嫩叶人间生鸾凤得来真虎子丹山生彩凤凤凰雏丹桂先枝一枝仙桂丹桂长新枝天上产麒麟攀去必龙鳞洼水产神驹天上星飞昴学语转春鸟剃头初罢浴人间岳降神涂窗行暮鸦对客竞添香孙枝龙种光祖有后荐祥奕叶凤雏荣宗传芳孕秀有祖风异时虽跨灶兴吾门今日验充闾梦蛇闺秀巽索祥光腾婺女弄瓦门楣媊星喜气应门楣治吉大厦迁乔华居规模华屋竹苞一亩花木屋冷云归早看山低凿牖簷前花覆地老我竹三径轮奂高门松茂万间溪山窗虚月过迟容月广开庭户外鸟窥人可人梅一窗凌霄峥嵘朱甍得高望月近水浮云倚栏碧窗留雾湿帘栊招月入得月突兀碧瓦避暑来风依山得月吹笛朱拱看云生窗户倩云封
哀悼::埋玉迅景挂剑故人零落梁摧鉴亡梦楹玉折埋骨九原薤露丹旐沉珠伤心绝弦往事萧条星暗乌止属纩兰摧招魂千古稼冰青刍星殒委蛇海外寂寞龙已化玉埋土坟三尺泰山颓人已远江山在魂不返仙游乘云天涯雕伤榻依然泪沾襟泪数行梁木坏月空圆星斗昏气如生骑鲸去空典册春已去兰枯蕙死花落水流月坠九霄郁郁佳城闭空咏碧云句化鹤归尽坵坟恨无穷雨暗云昏兰摧玉折霜飞半夜翩翩铭旐开不逢琼树姿流水生涯尽精爽悲长夜往事云千里海外故人泣燕人空市骨浮云世事空才华忆壮年高名土一坵天涯吊客来楚客已招魂
送别::舍軷挥泪短亭魂消野店立马离愁折柳关山行装驿路别时牵衣消魂长路泪滴荒村持杯别恨迎风道路去旆河桥愁地离筵泪眼儿女泪离合地杯中物草草别字对床夜雨登山临水风餐露宿征咯离觞别离情短长亭马上诗葱葱离歌匹马西风努力加餐北去南来此夕灯前泪路指云千里长因送客处锦字凭谁寄去远留诗客风尘为客日山接诗愁去他年日暮云魂消酒一卮忆得别家时刀头望欲穷愁多任酒酿江海送君情云随袂影分晴天开祖帐斜日送征鞍投笔虎帐金勒草檄健草画策露布鞍马金鼓须汗马无双勇曳裾黄阁据鞍貂裘锦貂运筹奇谋折冲羽书檄书旌旗出貂蝉第一功草檄青油风雪貂裘暗云迎出塞马雨雪双金镫笔下三千牍惨淡风尘际生马驱鸣镝关山马骨高风卷渡河旗尘沙一铁衣胸中十万兵悲凉鼓角声威弧控劲弦把手柳外分襟亭边临水返辔去路分袂关山江云离歌征帆诗千首双蓬鬓寻馆千山月登山还辕征途趋装客舍湘叶行计祖帐酒一樽独杖藜孤云万里天别夜叶频落曲中惊别绪大家长短驿去程山已寒醉失愁容浮世往来人衣钵衲衣一锡浮杯参禅戴笠云山藜杖诸峰飞锡乞食携簟草履吴山振锡一锡沾露重三千界喷玉禅烟霞丈室蜀岭路长是山皆有寺禅衣楚水栖禅片帆踏沙轻四百川栖霞室雨雪片帆曹溪途远何处不为家游遍千山路桂杖横挑月鲸吹洗钵水旧业云千里修行四分律浣衣逢野水缘穷七祖心芒鞋快踏云犀触点灯船生涯水一瓶护净七条衣乞食向人烟短琴云山蹭蹬闲云仙官去程素丝满吹宙夜槎杞斗桃源寂寂卧吹长笛古剑岁月逍遥野鹤世路归梦孤鹤飞采芝秋海飞尘天路悠悠倒跨蹇驴心随流水去身与白云闲
还乡::衣锦垂组返旆执手归路早行远水客归别思荒迳古万里归心腰龟佩印归舟分袂故园夜宿遥山乡关归期昔人非一樽别酒喜君无缓步绕屋落新树羞将新白发至家父老喜忽惊乡树出为我报平安开箱检旧书却对旧青山出郭壶浆迎渐识路人多
感谢::温润褒美一卷雅句美才风骚铿金清腴推敲鬼神哭风雷动清新秘藏数萹奇才新意雅丽戛玉壮丽超迈星斗寒造化开空余余上贵锦绣篇篇丽搜疑沧海竭锦绣原无敌留作匣中光冰霜句句奇得恐鬼神惊云浪声情绫文百幅花文厚意绮色千金玉版冰骨五色新凝月色云影薄窗下剪开一幅明霞辱君千里意不惜千金费薛涛花纹千金贵夺霞光雪光浮笔头题破十分烂锦惠我五云笺须颁数幅来故把花溪样素并吴绫美翻贻竹户人红争蜀锦鲜兔毛象管良工纤毫脱颖一束兔颖沾粉鸡距宣毫巧制圆管铦锋千金虎须带香梅福手中得鸡距初含润赐来分五色草玄方有志长毫资敏惠文通梦里传龙鳞不自韬用处妙三端操管敢忘恩圆管称吟哦
金::华山悬秦市三品张袖十斤指海赤气珍质六府披沙大冶丽水置燕台百陶满籯百镒藏山紫光刚形五行掷地洪炉赐郭治炉九贡形异逸价超和玉能成器铸范蠡招隐士沙中采出向日披沙静聘洪从革双南质坚加名迈鲁珠始见功偿不疑餽名贤炉里镕成含风振铎鸣许人一诺重越冶模良弼祭天封汉岭世重双南价自有坚刚操教子满籯轻燕台礼上宾掷地警孙声天然百炼精宁辞锻炼功
玉::抵鹊温润丹水栖乌粹精蓝田石蕴重棘荆珍待价韫椟雪融辟邪希世韫藏稷泽三河解热子罕固辞山辉浮筠鲁宝含章韬光水润照室连城雕琢昆岗六瑞灭瘢卞和自献山川借润韫藏在石德高比君子符彩照沧海玄圃名曾播永愿齐琏瑚辉山知禀异草木凝辉辨别由人价重抵连城清辉凌白虹昆山誉久传常惭混碔砆被褐喻韬光宁为田夫弃既遇明君献莫作楚人伤还求善价沽
珠::川媚吐泽照月蚁穿七采光明灿烂夜光照乘凤啣藏川漏星蛇报千金错落圆明明月连城昆池渊客编星玄鹤媚渊圆输十枚归瑶买姬灿灿光尤莹圆似丹砂合浦江妃舞鹤灵龟清水径才三色弹雀按剑荧荧价莫酬光如露水探龙殊九穴清辉照海月握蛇文足尚得自鲛人泣瑞彩含渊媚剖蚌尽千金美价倾鸿都弹雀讨何疏传因价客来寒光照乘浮修心念佛参禅系念看经说法养性胸前挂数分百尺休论始终数念善头头现谁言秋露滴积数尘难尽谈玄掌上悬善满三千须忘净垢心随心处处圆能节海潮音微穿蚁可寻
钱::三宜九府通神凿井选一九麻化蝶体圆方兄龙文流通青铜泉流贯朽梁上子母使惊成塘授三五铢飞蚨孔方堵物鹅眼鼓铸白水纸裹尘生杖头方圆轻重相催一时圆法立货泉流地上天龙带泉宝痴心守为虏汉日五铢健白水真人号方圆有制四海利源通圆法布民间地马列金沟俗眼诧如神姬年九府流青钱学士名能符光武起不救邓通穷
锦::蜀国织文挑字绿地文龙五色五采美丽蜀江翔鸾缠头秦川绣段识诗斑文朱雀千端千丝鲜明金谷舞凤系缆细葛雪纻雪麻束发织字花样若灯烛步帐簇成十样夸奇低垂疑步障轻缣香罗火布维舟添花霞生似云霞回文织出三时不废吹起作晴虹织羡秦川女金谷徒夸障粲粲冰蚕缕闲时云雁活绮织千丝细云浮山右日文夸窦氏妻随堤在系舟翩翩彩凤纹织处夜灯寒花攒五采鲜霞满蜀江春
衣服::龙绡貂裘缝掖风袂风葛襟裾楚楚青衿垂鹑纡青崩绪寒裘宫锦鹤氅绨袍云裾雪罗领袖飘飘白恰短褐曳紫缯文岁葛卒岁章身细葛半臂在谨藏金针纫处袖有天香惹剪自鲛人室寒念人无葛御寒被体轻绡在笥无轻授铁剪裁时襟无暑气清裁从织女机勤思女在机巾箱陈十袭细葛含风软戏彩夸莱子量币宝千端香罗叠雪轻垂鹑羡卜商
袍::赭黄赤霜金字玄马山水初缝念友赠绨惨紫青草蚕襭宝鸡流霞乍著吟诗夺锦帝后亲缝宫人添线
裘::狐腋鹤氅青凤鹔霜鸟玄狐貂襜一腋千镒貂青集翠皮厚雉头翠云黑貂狐貉紫绮羔袖千金三英狐白浮光毛深便知煖仁杰嬴来御寒宜老叟风有号寒苦北风知应候一腋应难就黑貂夸组丽不畏寒相如典去换酒称诗人民无索晚忧寒备谨时修千金未易酬紫绮袭蒙茸
冠::进贤顺德正体招虞五采鹿皮首饰竹采章甫峨峨星弁貂蝉楮皮成德惠文饰容遗越四重鈌柱鸟章金珰荐贤岌岌玉簪獬豸竹箨鹤毛角巾必弹虎皮玉润五岳光连斗文灿烂高人服盛礼尊元服穷奢讥?义鸟鹊尾岸帻不正蝉翅金明七星势耸天势巑岏散士簪佳名重进贤极品贵貂蝉尘缨辞旧隐会弁光联玉逍遥宜道体攒弁和星翳未暇逢萌挂岸帻俨新班长缨彩散琼枯淡称霞衣垂文偃月形聊为贡禹弹
巾::白帻白纶乌角乌纱红帕漆纱漉酒垫角岸著轻纱道衣岸纶裹头野人服威防垫角周家新样葛轻尝露顶簪花横簪醉歌白葛高士承露覆项逸士风老已盈簪陶令旧名帻堕自忘羁
帽::冒絮管纱方额首冠縠帽狐皮遗市护栉高顶倾盖乌丝贵孟家落漆纱唐谷紫纶容表乌纱蝉翼歌风隔尘短簷簪花新样奇王蒙贵纱轻堪岸著晓露鸦初洗已见笼蝉翼放荡从风落白头犹待祝慎勿拘时样忙中忘盥栉发短恐吹斜春荷叶半开无因映鹿胎留连为客裁乌帽欲何施须教到死宜醉任欹斜
裳::薜荔白蚬芳草丹霞云锦湘江六幅芙蓉青羽榴花白练留仙绣幄四围紫金百宝金鱼腰悬缙笏一团红玉万钉佩玉佩尾悬鱼百宝鞶革缕金金绅鱼佩摇玉佩幽兰佩入朝宜束悬腰堪缙笏横挂金鱼烂束腰红玉烂纫兰刻玉博带鹊衔挂金章百宝闻教自书垂足好悬金斜垂玉佩锵垂佩紫金横雍容整朝服鬓雪人间寿冰玉新颁李揖让节儒衣服金世上荣黄金旧赐房龙编玳瑁细罗锦袎凌波兜鞋缀珠履霜鸦头鸳鸯复纻红蕖细布形屣曳革蹑露动尘弓样吴绫玉笋奇样似月凌云舞玉生结处洛水步时衬步尘生蜀锦金莲彩光如茵画竹材村媪得时马嵬看处
帐::流苏连珠七宝九华甲乙覆斗三云百子紫绡翠羽罗帏芙蓉虎豹低垂白绡紫锦绀幄九真绣顶董子攻书红锦红珠绣幕玳瑁鸳鸯高挂乌练红罗青缣五色房纬马融列乐绣带两边挂蕙帐徒招隐月映不辞卷鸳鸯悬绣带流苏四面垂茅庵浪作禅风车辄自轻珠玉后流苏细皱水纹明窗龟壳轻明云叶暖室茧头明洁吟灯独坐书轩净明深夜灯残竹床焚香称芦花被纸帐梅花梦轻融茶灶安贫雪屋俭约障寒风隔禅榻歌枕宜班竹床泥珰竹叶香虽无百钱值月喜一家宜云母金锴罗縠锦幔绣幕春风琴瑟真珠读董生书金贝莲花文懤青油罗帷明月铿锵环佩运子房策
谷::玉粒青精如龙登豆瑶蕊雍梁玉屑粉梁蓂荚乞漂母坠化螺琼膏白粲若凤香萁琼靡云子冰精红曲奇稔进滹沱吐变蜂太尉甘粗软思素粲天台何处虽老尚善怀携囊滑忆雕胡卞御羹和石髓平津脱粟滑忆雕胡霜雨未休自比不殊空中下钵香闻锦带羹香卞进胡麻莼羹熊掌蒸豚凤胎鸡距金虀凫臛蟹黄兰苏黄领擘脯啄腐九汉鲤鲈脍驼峰胹蟞鸾脯猩唇玉脍驼美鹿尾桂髓白龙炮羔吞腥千里莼芍药酱通印鱼水梭花金虀脍枯犀筋三变味彭铿和味庖丁足倚屠门大嚼水精盐披锦雀钻篱菜玉糁羹听鸾刀五候鲭伊尹剪熬易牙手调素食逍遥珍惟八物炙贵牛心清浮玉碗佐饮时炮鳖鲜鲫银丝鲙如丝细生菜膳用六牲鲊传龙肉红点水盘蠲醒数鲙鲈香芹碧润羹似鸭烂蒸葫
饼::牢丸红绫粔敉白练银泥毕罗春绵十字琼肌映字堪窥卖之宜售四片分来英粉调成玉屑馎饦桂练一盂银线见风消去画岂充饥一颗终日剪刀裁出
酒::仪狄欢伯杜康醉侯浊胶流霞鹅黄拨醅千钟梨花玄碧琬夜玉醴渍桂桑落酒树椒桂清漂浮蚁蚁绿浮白五斗竹叶缥清琼苏金浆酿花茅紫曲神葡萄冻醴玉壶一杯椒芳竹根扫愁帚青州从事鲁蒲赵厚百金难著价色笑榴花重寒醅金盏数石玉液碧筩钓诗钩曲生秀才大武小文一醉即醺人香兼竹叶醇萸菊新浮蚁慰眼葡萄绿浊醪含妙理重碧金壶溢葡萄旧发醅抛人竹叶青醉面觉阳春余香腊味甜瓮下到载三行渴心户边杖头一石醉眼和杯绿成壮胆微成醑瓮揭开时杯浮桃叶荷叶杯浮蚁香蔼椒兰喷曲神寅日合上脸红展愁眉都是春瓶封贮后袖拂梨花桃花脸笑春杯深琥珀浮酒圣卯时欢小舟浮鸭绿饮凝金盏满见说醉中圣大杓写鹅黄醉倒玉山颓摇知但啜醨
茶::上品白雪方珪石泉新芽素涛圆璧槐火雀舌醒酒霍山凤团长泉道院破树露芽解渴一瓯雪腴换骨金鼎鸟嘴解愁顾渚龙焙甘露僧窗惊雷雪橤清神七碗云脚轻身玉瓯口甘两旗仙人掌三百岸细珠落小圆月雪脚乱香可爱入座半瓯汤煎蟹眼神爽双凤瑞草魁一掬春飞雪轻第三泉乳花繁品尤珍开缄数片屑碾龙芽香绕美人尘虑一时尽云开未垂缕自煎虾蟹眼碾细香尘起月中亡桂橤碧流云脚碎凉侵诗客清风两腋生雪练半成花同沦鹧鸪班烹新玉乳凝云外得仙葩香液雪花轻
小舟::月影望月风清浩歌举棹停桡乘兴荷香冲烟水净清饮回舟吹笛寻溪借凉月夜戴月满蓬秋月蓬疏通月云烟不辨风透荷香北斗三更席月明十领雪乘月水乡观星一笛夜风浪静见山星斗遥分波澄月色长江万里船浪急五更风举棹云先到移舟雨逐行
石::坚刚山骨雕琢炎天冰簟游仙冰冷凿得清润溪云通明暑热银床欹玉月弯琢成月幌通明如玉润如梦冷添孤魄野色抱犹在彩莹珊瑚冷莹若云无迹坚刚夺玉润冰床温润似冰清伴床孤催冷光烟痕拭不干光欺琥珀寒敲同玉有声清冷胜永寒龙头奇玉琢成豕腹良工镌就刻篆双耳藓痕刻石煮茗规模远难摹写八卦分巧工著意镌来辨无迹雕螭数升云色琢山烧香欸识明入画图万神骇伟士惠心圆实自天成岂能煮仙药但未污羊羹百炼尘昏宝藏旧样古意尘侵铭绝改变尘侵黑鸾凤古千古涩千年藓涩篆古新磨清光土翳埋藏推迁藓翳苍鬼神惊一堂寒清池翳萍藻月暗虾蟆蚀肝胆诚能照光翳经千载背菱尖尚在绿晖侵铭涩明月暗云烟尘昏魑魅过妍媸讵可逃形分只一般鼻兽角微讹朱斑点背圆琢成碎痕苔生坚石山中流水坚刚四平守道星辰灿支孤垒磨就苔迹雨洒扫苔林下古松方正一片鏖兵玉石争保一隅雨润苔生对敌应难料启枰书院静启枰侵藓迹荆朴磨为子风飘松落交攻不可移收子竹根移收子乱云根井绞砻作枰
尺::长短可度公平无欺律度累黍定规哲匠良工手累分元有法银星明有准毫厘积分有准佳人巧妇心积寸自无欺玉腕岂容私
水车::翻车灌田汲水腾翻逐浪轮转利物车咸车咸翻翻直牵轧轧引水蜕骨浇圃灌园俯仰随波回旋兴苗轰轰确确倒汲迢迢成流撒珍珠千项润高逾岸非牛功毂外奔流刺水涌流利浸千畴涓涓泉远轴波间声轧轧滋绿绮四渠深远遶城赖人力轭头两岸分畦走浪波扬两岸滚滚浪随轮月下影团团轮逐波间转声从月下闻激激转雷凿渠斡转激水喷春雪高低合中间定翻夜月能得势乾坤旋转霏霏喷雪开闸回旋济人发殷雷上下功上下圆转秋风有神功日月推移流水声中一围石齿岸畔雪飞罗震雷翻屋凿渠倾骇浪但得中心正绿杨影里三尺云根溪边雷震轮盘电转沟擘岸注悬流无愁眼下迟
斗::谨量一黍圭撮官私同始由升合起登升诚有法虽分左右耳均平从律起盈外十升贷收远近一终致釜中成角斛信无私不察重轻心剖析息民争
古剑::百炼锻炼沦落龙潭冷留万载丰城气色莹函秋水沉埋方出狱千年埋藏沉埋虎穴深鬻千金博浪沙光寒隐夜星会合却为龙几番径战国沙土埋藏久磨就白虹血有意断奸臣英雄激励多杨翻碧海尘
弓::七干燕角越麻黑干救日象骨定准六材楚帆青檀观星鳞胶成规东房弦木锡功绿沉交韔象珥贯船六钧鱼端缴矢锡侯形圆落雁西序饰金备盗绣质载橐桑弧击水九石弧竹装弢招士势曲啼猿射石忘归弯落月十分力称猿臂授士卒势若流水四林具美雕彤殊制张时如偃月发铜信往挂扶桑百中功逐马军志姓名形如月偃九合成规夹庾辨名发处似风驰艺精由中的六材皆妙物霜重鳞胶劲遥弯落雁影国藏为大宝制起自为基三制总良工风高月影圆虚引泣猿声时用更招贤
火::甄陶取日燐炙燎原夜明就燥野烧爨松冷燄化鹊光戟登库内阴蔽窗燃黎始然束缊晓爨浮烟炊烟燃竹寒光流乌生茅篝祠外照涂隙甄物弥壮徙薪炉存钻木山泽烈光吐夜金鼎转丹顺之有道炼药炉中晨烧树下曲突薪须徙珠扞焚芝玉石焚暖如春地炉添炭逆者无端读书窗下夜煮山头邻家火可求燃竹当清晓煨芋僧何在鸡荧机谁测烈烈威何炽燎原张虐焰钻枫欲暮天烹茶客与同乌流瑞已呈炎炎燄正高甄物有深功
香::辟寒龙涎细艾兜娄沈榆意可茵墀龙脑檀香氤氲三薰艾纳蔷薇伴月鸡舌耳松唵叭兜木还魂石叶旃檀沉水馥郁百和甲煎荳蔻院静百和清夜薇露笃褥寻波戈文若爱甲煎焚来毬盛角楪灵芳檀宇日长九真重帘荼蘼都大弓得薰肌季和追刀圭分罢杵碎沉光虢国金车千步犹闻袅袅轻烟搏山薰雾结日静重帘透宝鸭焚兰烬泰字三秋月云炉烟不断经年不歇微微温火沉水驻丝长风清一缕长金猊喷麝煤蓬山一缕云宝鸭火长存博山腾瑞霭沉水袅轻烟
烛::莲炬朱焰炜烨烟暖有泪融蜡冷焰洞房画阁垂泪帐烛奴清辉荧煌蜡香成行凝脂红光宫禁兰堂绝缨院中顾影金莲送光分四璧铜荷承蜡蛾飘花落寒食初传禁琐翠明休令见跋泪滴千行湿分光银粟排刻赋千篇铁缺浮烟凤起香连夜游宜秉宫窗红短莫漫加鞭心然一寸光膏融低柱蜡泪流非有怨补处金钗列丛花生木蓼泪滴嗟人别影抱铜芝直烬冷到垂莲花结不关春添时玉漏深凝密堕金莲花开喜信通光摇铸项圆
灯::龙膏豹髓朱烬凤脑葛笼寸辉芳苡粲烂冷焰锦筵寸光荧煌紫光金檠灼灼煌煌青光龙须荷盖余烬兰膏光辉寒烟绮席短焰照耀红焰兰烬亭亭耿耿酒肆洞房残花吐焰孤光添膏双花三更烟微寒夜短清透影聚蚖膏鱼船客舍纤影生烟素燄凿壁孤燄一点焰远冷烟空冷浮烟曜鲸甲静留寒夜雨色晃芙蓉帐烬随金藕细丹心尘岂染燃处花凝粟花垂知喜至自能当雪玉明彻晓钟时光空翡翠帘影透玉荷清明焰雾难藏挑来焰吐银焰稳觉风停那肯待春红半灭夜阑酒醒小窗幽堂无膏半照天将曙寒光欲落侵人燄冷频挑天晓梦回孤馆红炉欹枕微明夜尚深冷焰将吹照目光微已觉兰膏尽背壁愁孤客焰短犹余照锦囊名画卷萧疏孤馆方知玉漏长侵帷叹老臣光销尚有明玉局败棋收零落五更中低小近床提携照简高下纸笼可亲明灭长临照帏幕良夜携低更小临无睡客提挈当案懒向朱门光明蕙帐遍照高低高照伴琴书通宵照近尤光照读书窗守尽寒窗偏来绿幕藏因安暗处不照笙歌畔自小共寒苦二尺提携便月淡孤窗影淬砺三冬学用即致明时长临简策前相亲同见闻孤光照映明风清一榻尘辉煌二尺高孤擎光辉长照编简午夜照书星点照字可亲纸笼冷艳烟若清光焰吐字照蝇头黑花沉一砚水孤光光简萤光校书继晷古字寒光照然素焰花开光分豹髓红烟袅半窗风青藜寒照座照我数行字每对忘甘寝银缸光闪闪黄卷静留神凭他一寸光频挑伴苦吟宝训诵琅琅烜满古殿禅庵长明常生虚堂佛殿入照薄纸朝昏终年常花梵刹煌煌经晨寒灯剔瞻青宝髻光浮三界见经堂无独暗红纱春夏照夜不夜伽蓝耿耿彻夜冷焰添见白毫光明破九幽途法宇自生明兰缸明灼灼古今长独暗惟我身边影宝殿自沉沉画夜用常明要君心下明水外荧煌泽国远浦寒雨夜焰浮沙碛沙头明灭江村寒江碧江秋光映岸滨荧煌疑腐草一点寒江上柳际出还没寸影归寒浦水村明静夜来往讶流萤孤光远水中沙头灭又明孤光点夜船苹渚乱黄昏
灯花::玉焰报喜点缀寒光耿耿闪闪红艳金刀剪排金粟惟半夜人频剔金英得财累垂冷燄亭亭荧荧清辉锦帐开缀玉虫不争春妇怕挑一点芳心冷烬长垂粟开非资雨露结颗银台上常能夜月无根从地起几多嫩蕊寒苞倒折莲落不为风霜抽英宝焰间故不待春风有孕带颜开
灯笼::绛纱冰茧灯宵映光雾隔净纸荧煌悬壁蔽雨春宴罢风莫妒红纱罩体焰隔轻绡月夜缀影纱笼素纱照耀蔽风隔蛾夜游归雨难欺白茧围身光围细幕夜阑归客馆弱骨千丝细雨丝风外绉万窗花眼密双双来复道屏展辉云母红罩阑光密坐久照书窗轻毬万锦装云网日边明千隙玉虹明两两下深堂帘垂晃水精光随锦麝浮
琴::纳正离鸾四善流水得意弄曲雅操山水彩绮古意指下松声金徽宣情别鹤七弦归风知音吹弦正声丝桐朱弦浮音弦中泉谱玉轸一曲宫商焦尾巧奏高深元鹤舞风正淡来爨下一两曲独鹤唳云得指间意五声曲调无弦轻调妙趣白鹄翔月初明到人间千万声雏莺依树传徽后声一曲起于古静恐鬼神出清音飞雉操子期不得听此声含太古谁传广陵散几人听到今急疑风雨寒雅曲白驹诗叔夜古为弹谁听到无心斲尽峄阳林良匠功就经心制经营徽远近古韵终难到桐材韵成入耳清辨别木刚柔孙枝亦就寻舞凤古韵素女寒玉风吹空桑跃鱼遗音湘灵响泉雪散文梓洁心邯郸道悲帝子曾晰鼓文鹄闻白虎神人试忆华年依稀江上粗弦参广乐胶柱陌上桑醉佳人孔子歌艳云起赤松仙子休听北鄙仿佛风前疏越荐牺樽凄清和万籁古调凄金石冯大弓空自舞赵女宣孤愤断续遶三湘清音入杳冥楚客不堪听湘灵写断魂
院::枵腹急雹流泉清声四弦鸣乍歇清音哀鸟明月雅兴修项碎相连阮咸创物元澹知音
琵琶::马上项曲中虚莺语回风火凤龙首小怜昆袅弦转关轻拢江头盘圆外实泉流却月水蚕云头大道铁拨获索慢撚素桐一曲怀去骇耳雅声蕤宾曲感四气太真妙高丽画奏六引阮咸善丹桂四弦抱来娱心远耳爝轮袍候八风段师高秦汉工理五章范晔弹昆鸟鸡弹处思妇有怀指底商声冒妃抱去宫人罗黑半月分弦出弦中传意绪促节劳红袖鸲鹆听时征人无语舌头胡语贺老携来别驾小红丛花拂面安曲寄春情清音满翠帷凄清和万籁铗弹风响急断续过三湘缓曲漏声迟湖上怨声依琴月下危柱垂珠濮水孙赋桑间愁曲考筑风前哀弦碎玉钱溪顾歌斜抱新曲坎坎关情挑吹金凤翅繁弦十四声声清怨师延制曲轻弹怨声冷冷写恨催舞玉螭头古寒三千曲曲幽情狂叟渡河素质琼柱清音金丝秦声朱弦逸响雁柱东宛莺吟争弦杂合洪纤轻按玉柱应六律扬清音赵曲银甲新声莺鸣西音燕语促柱疾徐断续频移檀礼总八风播雅声弹陌上春色有始终三五指中推故引新指按朱弦急新曲弦中发尘多涩移柱歌秋风晓风前不盈缩十三弦上移风易俗风穿玉柱调清音指上来风操泛调弦钿装模六律甲鸣银的烁柱列配三才柱触玉玲珑别鹤珠垂兽舞七政列管竹韵妙曲参差月下离鸿玉振凤鸣二成施簧风声清音断续筵前疏音白玉移风俗排凤翅分宫羽春透梅花双成度曲罗袖拂来匏来曲沃逸韵紫鸾遶阴阳胜龙吟拟短长韵偕孤竹子晋调音小楼吹彻林统众清海上白云雅将镛间奏形写歌鸾翼凤声初嘹亮绛唇吹妙曲会激荆王叹幽情应节转洞中流水清比磬同音身随舞凤衣鹤舞已婆娑丛竹写清音还生楚后悲逸态逐声移管清罗袖拂响合玉唇吹
箫::七数编竹蓟宅参差酉单酉单陌上乞食潜蛟乌乌度曲秦楼九成带牙越宫刘亮肃肃城边给丧婺妇袅袅善吹汉苑编云凤飞上下鱼出瞰秦女鹤龙吟细管换言笑楼头人倚气接虚心轻清杨柳曲镂玉蛟舞高低凤来仪茅君鸾凤啸迟彄分雅颂桥畔月明手持劲节和乐凤凰音参差横凤翼危声合歌鼓虞舜调清管庄籁明天理风前松韵淡搜索动猿吟绝美混笙箎王褒赋雅音虞韶见帝心月下籁音清
笛::畅神论意激朗摅愤断肠清哀怡志卧吹奇韵裂石流羽嘹亮龙鸣感旧呜咽咽咽翠篠寒江折杨柳写神倚曲横吹穿云泛觞凄清鱼喷断肠凄凉悠悠霜柯奇曲落梅花牵客恨绪湘渚云禽婉昭华管马融赋吹落月龙须半剪碗上一声水净天涵镜和江声吊汨罗水龙鸣柯亭材桓伊吹遏行云凤麝微张江边三弄风回月汉船数声寒月底切切随风到逐吹梅花落惊梦雁行高飘飘带月清含春柳叶惊荒村一曲切切古坡夕阳村腔古迳千林悠悠远岸秋色野调随心巧横吹无调牛羊欲归去几声连野唱牛饱欲归去隔陇鸣频弄忘归烟雨半晴天数曲引新愁人闲独立时月下呜咽柳岸江头清哀芦洲一声日落曲岸一篙惊宿雁吹长笛叫晓江天水云闲处间将千古意渔舟烟霭暮几曲月明闲塘三弄感离人钓巨鳞吹残海天波浪深时吹入一江秋溪馆水连天
角::月夜征人吹月残月断续调古沙碛苦调塞上喙短吹落月带霜吹惊战马霜秋宿雁悲风夕阳凄凉声寒塞城新声风前吭长送残更和月听送征鸿添离绪促低沙塞寒带雪霜促曙调悲晚催边日凌霜侵晓塞就风吹宿雁调入高低响弄落梅散入榆关半和刀斗背风声远寒遏朔霜带月送寒声和月起征人风飘断续声乍写从军乐浩江增野思切切和声落还歌出塞行久戍动归情飘飘带月清
钟::碧玉三纪两栾思武发鲸雷师郑抱浮金六平九乳锡文绕兽凫氏周编左三旋虫二四攻罪万钓声远月夜远寺远韵惊梦遗音春容倕作右五雊雉十枚铭勋千石音洪霜天高楼大鸣知时逸响浏湸禹铭设虞鲁铸虎章鼓舞悠扬庙中江水字吴札去撞斯应有余响景阳楼上谐声齐悬狮钮鏦铮断续庭下霍山文杜蒉升和则鸣无尽声寒山寺前调知师旷明月诗风霜中寻逸响雉雊千钧集秋至含霜动平陵通曙响晓韵传精舍铸验杜夔碧纱笼处江上辨奇文鲸撞百里闻春归应律鸣长乐惊宵声晨音彻梵宫形虽挂禅剥声已彻人间
方响::秋夜调合金声韵清响亮月夜扣击古曲玎珰在架叩石犀搥雅韵震月声寒秋寂韵韵和琴瑟凄清泉声均调清音戛击敲风敲金琼液清声回风节促夜铿锵调合蓁筝疏篁销竹韵月出还增兴不因人击拊月下玎珰响流水戛泉声风来倍得清安得夜玎珰风前戛击声
鼓::庙西高下电兽和音简简座左杨柳灵鼍进众渊渊鹭飞铸铜弗考警众双搥架上援枹冒夔雷门解秽庭下传少昊铺和奏铜扣戛玉其镗催花三挝棚下作气栖鹭路越发春庙前肇伊耆揭正声能协笙篁气作三军几声考击不异雷鸣抑扬三令内筵前将舞凤美玉随天仗解催歌舞声闻百里众乐参和恍疑鼍吼和乐五音中庭下正鸣鼍灵夔集帝功渊渊驰雅韵不为求言立未辨吴宫鹭坎坎震和音还因警众鸣还收骆越铜山间轻击奇音警众野叟刻木月下浩歌清韵虚心道人垂籐急拍警俗乐听忘机声闻仙意足神仙乐回心客执竹圭三尺影横茅庵风定处长歌修行回心有节静听道家宜鬼魅愁向上人簪柏叶数声响彻仙洞月明时影横孤月落无心能警众无人真落魄声入白云秋有势欲凌空信水逝逍遥
音乐::涤邪道志赵舞会客雅韵钧天大夏歌钟荡秽通神燕歌娱宾新声调露成周舞籥省风燕竽昭德鸾歌天地顺致景仰成万物飘清汉宫商应迭奏八音来凤舞考俗赵瑟表诚凤吹阴阳和感鬼神节八风遏过云笙磬自相和三叹动民声浮云成舞曲哇淫空众耳闻诗六义辨燕姬呈妙舞笙歌调细韵白雪作歌名中正涤群情睹漏八风平赵女发清歌箫鼓咽清香弦管观德鼓钟响方错杂和气节奏丝竹按曲歌大雅声曲雅声何婉戛击新声缓奏笙镛郢曲高歌铿锵至音纯和笙箫感人奏钧天韵悠扬倦自忘铿锵妙曲合鸣金石魏侯卧听阳春高调竹枝词阳关曲七德歌白头吟鸲鹆舞沧浪曲梁父吟金缨曲白云析声杨柳怨易水歌八风舞黄鹄歌鹧鸪词欸乃歌广陵散绿腰催行路难霓裳曲别鹤操明妃引柘枝词青玉案解剑行湘中咏一戎大定思归引团扇歌伯劳歌绿珠怨羯鼓曲白云谣望云谣塞上曲八铉同轨
歌舞::发德白麟八阕永言吐羽灵芝遗声浩唱落日象功执盾俯仰千童咏功赤凤九序厚志含商宝鼎游响曼声流风明德持矛抑扬八佾应声凤翔波回逸态垂手歌扇遏云鹧鸪胡旋巴渝歌声北里乐宾主合节鸿翥风转余姿缓声舞衫振叶鸲鹆回波浑脱舞态西城谐君臣送易水发皓齿飞轻裾回波舞歌声定应规度惊睡鹤歌振秦娥绿杨合手舞望秦川动朱唇纡长袖得宝歌舞袖齐合宫商起潜龙舞低飞燕黄鸟缓声歌香飘歌袂举翠落舞钗偏
字::六书八法崩云飘扬蚪斗丹鸟灵龟柳骨挥毫铁画舞凤蚕头倒薤八体一家垂露严重凤龙白鱼嘉穗颜筋染翰银钩翔鸾燕尾悬针鹤头屈玉奋雷绝序龙鳞蓬振云爝玉润扶石冲霄云布烟霏燕瘦虎爪垂金坠石颓峰趸尾沙惊蝉轻金生奔泉捧日星陈雾结环肥墨池绾春蚓铁门限写练裙锦囊贮法弥精云烟起驻马观碑体别双毫笔陈挂秋蛇太湖精书竹扇玉匣藏人竞市锦绣陈停舟索字书成三色轴动星辰转锋能挫万物玉管临牋滑势写龙蛇古写成天外态笔飞鸾耸立笔停风雨余阵独挥千军银钩耀眼光形铺锦绣奇惊动世间人章罢凤骞腾凌云垂颖金剪龟体飞毫钗头盘龙悬针人文铭鼎丹书碑额方圆流峙端妙玉箸龙麟拂素鼎足快剑倒薤鸟迹古碑柳叶印文瘦硬昭回通神周鼓八体刻符新鸟迹石鼓苔深锁蜗涎留坏壁荒凉汲县冢石经一家摹印古钗形秦封火屡侵鸟迹印平沙寂寞鲁王宫狂逸凤舞淋漓蛟腾鹰跱霞催剑舞扫兔吹林风雨龙蛇萦纡弩张蚓走蜂腰行行健纸上云烟鸾惊风送江声飞鱼扇树鬼神珠玉变态剑拔龙行鹤膝字字古毫端神鬼体样看来怪清奇宗索靖纸上龙蛇走腾云度秋月云露毫端吐挥符惊神鬼龙蛇画不真雄伟效张颠笔头风雨生老木挂寒藤龙蛇纸上飞活笔走龙蛇
画::通灵致两丹青一毫落笔江山比拟远景笔端天机手挥作绘受来数行点蝇藻色五采点屏水石仪形生结胸次心匠笔精章施遁形几转舞蝶风云点缀清标挥毫山色随月布红千点人不去擅花枝目送手挥下掩荆关松石轻描雅致丽墨江流逐腕生练一钩景长存工山水通神穷态上追顾陆倚云孤桧胸中邱壑四圣擅奇野桥分道路山分浓淡翠旧游心目省云烟生笔下挂壁高泉雪芭蕉三家鼎立古木薄风烟叶间浅深红信手笔都成山水约毫端宛转回纹锦缣素挥毫粲萦盈连理花丹青著意描点缀意匠素壁岚气涛声青来舖张天机高堂波光山色绿远雪浪泉石飞湍一泒绝岸波浪翠霭良工翠叠怪石野水毫芒内疑地涌烟岚岚峦怪石数层孤峰云烟苍烟妙手寒凝飞家陈林咫尺间似天成笔锋健远瀑下空笔墨安排烟岩万叠远看山有色黛青野色峰随笔上下墨迹深乱山叠翠山河整顷云壑千重近听水无声翠碧写溪光浪逐墨连延白波浮粉壁岭雁随毫末座上浮三楚青嶂插雕梁川鲲饮练光毫端会百端
传神::写照妍媸面目容仪遗像妙笔形韵俱全图形仿佛精神骨骼如生传神神情兼得因邱壑言十年被褐泪眼描来易发鄂褒骨一片灵毫愁肠写出难
山::危峰冒雪绀碧壁上云淡驰誉叠嶂出云丹青屏间烟浓入神高手峰峦巍峨笔下野色峰峦方寸云片满岫云烟笔力千钧峰生笔下尖形草树峭拔毫端岚光岛屿千寻松枝一林松竹春云万壑林出毫端千层岩岫鸟啼疑有韵烟岚分远近暗谷非关雨幻出孤峰峭林峦生笔下嶂树精神秀万仞云山花落不闻声云岫列高低丹枫不为霜挥成怪石奇泉石发毫端峰峦气势回万里在咫尺千峰起毫端
水::湛湛疑动隐映去势一川笔高健笔如流骇浪川流粼粼恐流苍茫流形几幅势急惊涛欲动寒光不激挥毫看有凤卷疑海竭扫开烟浪阔静看疑无底高堂翻雪浪野桥分子细烟光无点滓拥碧听无声铺恐堂浮写出练光平闲临恐有声古壁壮风涛沙岸远微茫练白绝纤尘剡溪腾细浪观澜清可掬金井涌寒波听浪静无声
松::偃蹇黛色雪干不老孤瘦存劲节霜雪操婆娑虬形云根常青屈盘布清阴岁寒枝纵观鹤骨千古不凋一幅巨绡笔下苍枝老不老千年操人无偕趣处老枝傲霜雪好看虬姿四时长见千年老干毫端翠盖新常青四季容鸟有误飞时偃盖走虬龙
竹::一幅瘦叶造化霜幅半折竦节风叶嫩香舞态笔端非种妙笔屏中数竿寒梢心胸烟枝横斜瘦茎霜枝新粉枯形毫末不生芳枝笔下拂云长笔参造化向日本无影月来疑有影瘦叶随毫长临风枝不动遗踪留水墨落笔成枝挺精神临风如有声日射恐成阴纤枝逐意成向日叶无阴劲节饱风霜节随神笔长枝逐健毫生
梅::功成寒梢笔下霜传清淡石落有色粉萼毫端蓓蕾意足瘦萼胸中烟笼横斜云开无香烟枝心匠清幽疏影吹夜月香断孤山笔神花摘素淡墨分斜影月落空留影枯枝生笔下影逐松烟落冷香挽春风标分南浦墨淡影横斜新缣扫劲枝风来似有香芳蕊发毫端花随笔露开清香凝暗夜疏影卧黄昏
花::松烟墨晕有艳密叶蝶认图上两朵粉色绿叶艳丽竿雨毫端无香浓花蜂窥屏间一枝朱颜红葩像生红绿展处春不老无荣谢屏间绿毫端妙干蜂频来探屏列枝枝丹青妆美艳丹青看来色长新自芳华叶底红胸次潜施蝶屡过寻图开朵朵红白散芳姿不假栽培力花心起墨晕青春不到处松烟滋密叶有艳人皆看何劳雨露恩春色散毫端红树自开花笔雨润方丛无香蝶自忙
龙::洒墨鳞甲含毫云烟颙颙点眼喷雾峨头角翻巨浪才分鳞鬣金井水寒喷雨精神健笔繁如喷雨矫矫穿壁拏云露爪牙拥祥气已见风云剡溪云涌拏云气象雄墨重似拏云
虎::妥尾食牛藏牙威豪妙手伏出幽谷随意摇尾落日横行镜目负隅编须类狗露爪气象点眼成威蟠山成障咥人荒山当座戟须蹲地山先动伏波立训无言先立意聊假管城子挥毫聊可象沙漠日光暮草自寒文质写形未啸已先风戏写谷于菟有力彼能知风林霜叶飞
马::设色通灵风鬃骥足龙驹妙手精神首足如凤木质韩干宜施玉勒露鬣追风骏骨良工骨相丹青入神奚藉日磾欲动霜蹄
鹤::欲动风采如飞精神风格妙手壁上长身低昂警露梳翎云外笔下将喙绝品人间少图成野性仙姿良工屏间清气磊落啄苔引颈屏中图中欲飞通灵云外多挂起仙姿粉翎随意长开翰将舞处但见图为六意中生羽翼丹顶运毫成引颈欲鸣时那知寿历千笔下起风云
鹰::猛气素练金眸殊姿神姿修翎剑翮独立眸明如电攫身思狡兔爪利似刀侧耳似愁胡
大雁::芦花水墨如绘落笔泽国入神白水扇上蓼岸扇图屏风如生江天无价黄芦屏中鄂社衔芦短翎真有态红蓼岸渭川避网长颈颇如生白苹洲
鱼::戏水雪鳞扬鬐舒迟意洋洋如在藻剡溪扬巨鬣醉翁难缕脍依草赪尾鼓鬣游泳形泼泼欲吞舟金井涌修鳞钓客谩垂钩
草::郁郁萋萋烟丛青袍柔茵谢池醒醉异彩楚甸嫩色映阶碧连天远芊芊苒苒雨叶翠羽芳毯南浦迎凉奇香秦原柔香入帘青拂露开湘岸曲竞春华金谷园中灵运梦池结成翠带接续连天远翠染和烟叶烧痕青改变楚江滨经寒碧姑苏台下江淹别浦吐尽花心蒙茸匝地荧青摇缀露丛席地绿铺长金谷人亡后步履宜轻过空随白云暮沙场日暖时开筵得晏供重起废城春荡漾匝地凝烟迷路醉客苒苒列翠蒙茸迷天带雨绕蹊牧童茸茸牵愁西塘金露衬步拂拂秦宫林坰青茵展王孙赏青遍地烟外去鱼舟岸南浦带烟遥看霏霏汉苑野亭绿带长醉客眠碧连天雨中来牧笛洲官道上铺花径连楚阔青锦帐诗人梦断冷设烧痕满泽翠阴堪书同缓带古宫中接钓矶入秦迟碧云低离客魂销细舖春色一川春景入咏似青袍堪随游子路书带青全短蒙茸连匝地王孙曾寄恨莫使香车碾烧痕青不断远入鹧鸪啼裙腰绿未成荏苒欲迷天诗客谩索情留供醉客眠碧色远相连依砌两行芊涟蚁过露浥连延晓露密覆几丛碧润簷雨萤光掩绿满窗前遶堤一迳滋茂蛩鸣烟笼曲折秋虫浓遮四季春美窗风蚁穴藏青辉帘芊茸依砌密遶砌烟滋翠径小看仍合细细凝烟重几丛依静砌荏苒匝庭开沿堤雨濯青蹊长望愈青青青遶砌生数簇匝闲庭国香紫茎幽香芳馨结阴清香燕尾光风秋佩绿叶弱态秀质擢颖芬馥鱼魧清露丹颖风泛谢庭幽艳晔晔深林纫佩三春细叶孤高丛生露浥绿艳紫茎露滋楚畹芳丛猗猗幽谷援琴九畹清芬素淡人服烟笼紫芽知其芳无俗态柔芽紫溪涧碧骚客赋供诗卷堪为佩比芳草能解秽耻萧荣化为艾有清香瘦叶苍箭砂红郢人歌入卧屏忌当门起椒兰巧凌霜同茞赐感德罗含烧烛扬芬为王者香叶如壮士被皋凝湛露幼时期作佩孕秀邻芝室微祥燕姞浴汤致洁入善人室花似曜仙滋畹泛光风生处莫当门芳名擅国香簪抽斜玉紫日月三间迈虽为通国宝花吐断心黄乾坤九畹宽而有出尘心养性堂北凤爪饶蝶近砌绿叶疗愁兰边鹦翎引蜂匝兰黄花佳名蝶采微香长条解思仙骨生叶早超凡卉清香细猗猗养性茸伴榴花贵品蜂奔嫩绿细叶忘忧道出花迟擅美名翠景稀灼灼宜男藉地槐叶鹦护翠翎色并仙人露金冠含日丽蝶戏偏宜白庭前欺草绿与菊乱佳色丛疏露始滴凤藏金爪香传少女风玉柄舞风长蜂来更缀黄堤上笑莲红共葵倾太阳芳余叶尚留春条拥新翠忧花明夕阳
芝::商岭紫金三秀谢庭翠羽九茎朱柯呈瑞九华含秀晔晔幽质朱叶商山结叶避谷不种琼田茎宜紫紫荀为祥五色应祥煌煌灵华翠茎汉殿蟠英疗饥无根玉殿色贵黄函德殿黄金蕊呈天瑞宁虚应履昌运从地应浮化日气分阳夏灵根蟠错甘泉宫紫盖荣表地府已兆府应佳祥自天成拂祥风根应中天宝叶蝉联穆穆醉客不缘雨润灵龙层瑞绮黄金九华殿色带朝阳静清秀临幽砌仙质人谁识煌煌宝座端自地成宝盖错文犀紫盖六英通光涵宿露滋飘香散广庭幽馨世罕知斋房辉玉斝迸质金柯烂岱检杂金泥骈头玉色荣
苔::没阶闲堆团团流地满庭雨积翠痕石发似铸翠晕鹤迹生阁乱叠个个盈阶匝地露芽斑点地衣不模绿痕蜗涎绕栏青钱纵润点点幽景染黛积翠空庭花绣锦浮鹅眼春工巧青荏苒积地绿毯虽多鳞鳞闲阶微圆牵愁闲地草成茵织翠毛夜雨零翠蒙茸凄凉秋光遍地不产豪门雨成草绿密镇怜庭竹鹊践轮还缺青青堪万选困窘中春色掩门更生穷巷风若花红深藏恨砌芜绳穿窍未通叠叠类三铢点绿疑施黛乱叠幽庭畔山疑和雨买雨痕霑处冷圆青不范金闲堆小迳边地似带烟租萤影过时红
萍::无根东湖约风乱青繁滋有实西涧泛水点紫摇漾生事鱼戏聚散点点随岸有迹藏鱼翠纹晚晴后随风动鱼资戏跃两岸翠藏荐羞鸭茵飘零纷纷临流无根浮水绿点春尽时逐水流龟荫清凉一池叠散浮沉因雨打雨翻千点紫微根无所缀浪起时疏密晚时妨鹭浴开张虽有叶飘荡终难测散乱为风吹风约半奁青细叶讵能茎风翻乍紫青夏暑盖鱼游流荡本无根流连如有情
芭蕉::春生庭外夏长窗前绿叶绿干青凤长叶临风半卷界纸凤尾绿扇战雨洒洒潇潇中虚红花丹诚绿章赤心疑月斜欹抽书书缄翠牋翻风亭亭滴滴倒插鸣夜雨叶垂鹦翅乱战三更雨色侵花迳晚怯雨双旌卷叶外更无叶静里缯争制战秋风花插凤冠频敲牛夜风阴过竹窗凉临风绿施高心中别有心斜窥扇欲裁
花::芳菲不言蔼蔼繁华深浅丹青臙脂绣叶锦萼撩蜂馨香倚云蜂穿妖艳相映夭夭艳冶低昂红紫锦绣琼葩丹葩引蝶烂缦映日蝶恋金谷潘县浥露云霞逞华锦宫城四娘溪迎朝露罗绮内千种萼枝枝带露武陵隋堤薰风富贵争妍香世界五侯馆折晓风画图中万枝葩朵朵向阳淡白轻粉丹青谁点染含风呈美艳西子尤浅竞学香罗剪清香薰晚浦蝶恋频敲粉缀红薄染霞红紫自低昂带雨散秋香杨妃浴未干何须羯鼓催冷艳灼寒空蜂围失报衙风愁盖紫秉烛幄蒙经眼连日赏爱和风嫌朝露重高张翠幄雨恨藏红筑台铃护断肠继夜游憎霪雨厌晚尘蒙远掩青岚朱栏护常愁鸟踏别艳犹堪赏只忧今夜雨日斜鸣鸟思莫辞连日赏锦帐张预恐莺栖余香不忍闻又过此年春春尽老人心预约隔年游移槛环池栽培斸藓几丛尘外种今日移种移来从别苑对人夸锦里只因贪众卉灌溉引泉数品雨中移他年看花栽处属豪家留客醉春风宁惜费千金双株分种刀剪偷造化分新种两地生花凭生成力暂凭人手妙意穷生理一气寄生泥封助生成变宿枝一枝造化夺造化权要夺天工机心夺化工作歌卧酒钿车华池携酒寻香开筵金樽对景花影临绮槛香随杖履销恨洗金谷紫陌题诗劝饮把酒檀板招朋酒阑倒芳樽气溢衣襟席临芳树狂吟应起早提壶招饮语钗戴小枝烂醉又归迟戴胜倚香来迎风醉帽高插帽侧胭脂色香掩冉招蝶舞筵斜簪钗横锦绣香影婆娑起市来侵早开园采及春摇风覆阶日高交加漠漠酣玉砌描不尽能邀舞女映日印地月上重叠徐徐上瑶台扫难开解引游人被云收去因风摇满地香留游子憩婆娑随晚日映窗红有态覆盆如濯锦待月送来随日转回廊静伴醉人眠仿佛逗轻阴印地绿无痕漏日似筛金几误家僮扫犹教醉客眠风飘随流点苔萦沙风妒凋零舞红香销随风积翠雨打著地依藓惹草月怜狼藉堕粉色褪著雨堆红片片残叶雨余蜂粘春减雨摧绿暗委红寂寞空枝苔遮燕愁月冷纷纷败枝风后鸟散阴浓风扫红稀坠白凄凉残片泥污莺惨烟空无人扫舖水碧埋国色西东逐春涧底萦草木蜂蜜冷回风舞埋芳草肌削玉有鸟啣点苔红舞山香高不飞晓风前委尘泥燕泥香半面上舞筵脸销红皱白离情疏雨潇潇蝶蜂有恨落时自舞遶栏仍聚散乱红堆砌玉暗水空流径腻红愁态余香细细风雨无情扫后闻香逐水向东西残翠逼窗纱春风半掩扉随风红雨乱静堆青藓地梦短疑成蝶舖地锦茵张闲缀绿莎丛肠回却掩鸾路傍原上水村潇洒薄雾冷艳隄畔山际山馆凄凉淡烟清香随地势甘亲薜荔不假栽培力芳丛乱荆棘长红欺短白开落浑无主见天真料比酴醾全凭造化功佳色缀尘埃深绿点轻黄芬芳自有情万叶群艳浓艳冷艳腰纤淡浓竞秀媚景深红弱体倚栏千包微香淡红清香脸薄娇困争研韶光浅白柔枝向砌数朵凝晓露免莺睍睆照眼新就点繁华景芳姿饶霁色香送微微韵妖姿随变态千葩藉春风引蝶翩翻扶头酒半醒铺陈明媚天浓艳占韶光花开淡淡红薄命易飘零
牡丹::姚黄美肌魏紫腻体国色嫩红贵品异香百叶媚春檀心千般无语馨香金蕊锦裳红衣天香娇绿奇葩妖艳三春倾国锦萼多品有情富贵玉肤玉珮金缕酡颜翠盖妖态风流嫩叶低昂同妃枝枝丽无双艳吴苑艳莺未识千种态腻体雕栏醉颜富艳芳心向背对客朵朵奇第一春汉宫春蝶先知十分芳三月胜饶体态金世界如欲语妖欲动沉香亭北叶叶月明翠幄乍笼数苞仙艳百花魁斗精神玉楼台不胜情恨无穷粉镜台前娉娉风韵檀心欲吐一片异香颜色依朱户国色千般媚艳丽随朝露落日含明艳杨妃娇舞态粉光深紫腻馨香满玉阶天香一种奇馨香逐晓风轻风袭暖香西子淡痕肉色褪红光蟾精冰肌素质国色佳色琼肌雪萼琼花素艳露洗月下绰约藏玉块雪魄玉骨淡仙清光玉貌银苞瑶蕊清香风翻栏前芬芳倒银杯色如琼液不卸铅华莫争素态谢台妒叶底风应暖蝶趁清香去妖娆凝雪色光妒粉腮祗裁银缕休斗精神添月榭光枝头雪未消禽随素艳来淡艳动天香都无尘一点白是银点肌融暖日素逞雪千葩红疑玉剪裁玉脸笑轻风对发相依同枝并肩二乔齐开并立并蒂对镜双魏对舞倚风对语相倚分瑞如相泣相隐约薰风对折国色呈双媚娇娆原并蒂齐醉露同愁同开对各自香斗轻盈浩露双滋天香总一般艳美本同枝势如连璧友含烟如有意风摇疑对舞红芳开并蒂情若臭兰人笑日似多情烟重诮同眠绀叶竞骈枝含蕊折晓露蕊露苞开迟风葩蜂狂造化翠丝未吐不语深藏人待赏蓄积异香檀心犹未吐天工犹吝啬蝶乱天工绀蕊绝香含娇渐放蝶先知韬藏绝色玉蕊欲飘香国色尚缄藏仿佛开檀口未放新脸依稀绽绛囊偏含不语情三秋冷艳玉露迎玉露菊花露免使莺窥九日秋香金风向金风桂子风尚余蝶恋花动何郎兴香腮啼玉露却将倾国色似因蒙厚顾远思桃径暖香消宋玉悲檀口笑金风特地嫁秋风不惜为重开傍笑菊篱贫妖红姹紫迎寒风日丽侵凌雪色方当群水折应如慰霜日翠钿临风薄留景雪霜欺漏泥春光也趁一阳私似欲嫁寒云脂容惜日匀
芍药::浩态翠茎狂香红蕊翠槛红苞红艳金鼎翻阶欹红醉露贵种烂缦金鼎馥香锦囊乐天吟朱栏翠叶紫香玉盘傍砌覆翠歌风艳妖娆玉阶红缕金碗元稹赏三月见汉苑紫云媚态迎风笑脸嫩舒春日洗青女色叶浓翡翠钗茎抽碧眼百花惭扬州红日芳心幕雨寒花浓点晓霞雕玉碧娘楼花好晕胭脂粉蕊扑黄丝绿萼被风瘐红袍挹露肥叠叠映牖天工重台带雨点入画露浥牵风重重倚栏造化并蒂含烟剪裁题诗云栖带雨同药使楼瑞玉重重看不足浅深诸品异青帝勤点一枝开暖日叠叠迎风媚亚花王冠缕真金叠叠画难真堆叠几重危东君巧剪裁千叶照明霞层层映日鲜
葵花::卫足晔晔冷艳倾心向日金盏道新染倚风下吐不俗微香倾头青青幽妍吐萼临风黄冠仙态淡倾日中央出尘映水凝露云鬓轻盈态菩萨面清似蜡梅叶如鸭掌金盘侧耀烹同豳俗两畦飞雨待霜露雅淡女真衣色如金菊花有鹅黄檀炷凝香煮向蛮林一朵新凉参差迎晃日芳姿浑似蜡绕槛千枝翠抱香含暑雨萧疏秋日景不入当时眼潇洒对斜阳冷艳净如金欹簷数朵黄侧脸笑薰风淡伫道家其如向日心换紫翠萼锦苞霞艳竞夏暑雨庭院参差浓艳美色向日引蝶分照翻红丹华绛萼锦标倾阳薰风藩篱烂熳芳苞修枝凝烟招蜂独荣浅紫入尽庭前绯纱疏茎娇柔折高下数丛如霞多向背锦苞倾丽日葩疏偏向日深红堪吟阶畔绛蜡密叶次第开浅深一穗似锦密参差绛萼舞薰风条脆不禁风心露黄金碎不羡朱栏抱香含暑雨叶敷青玉深何惭僻地中侧脸笑薰风
紫薇::堂前小槛畏日茸萼映水拖蓝锦英繁秀月中伴桂子明雅艳阁下曲栏摇风赤茎窥淡白霞艳葳蕤栏下接黄花散清香浅碧笼裙辨绉曲裾树动情何密几岁自荣辱此地飞尘隔数枝临省户赵后鸣金瑟轻红霏雪跗攒蜜蜡花浓艳欲飞高情方叹嗟经时绛雪翻几朵入宫闱秦娥卷绣帷
柳::掺径轻盈散乱舞榭雪点春绵乘风漫天袅娜轻狂点衣琼飞晓雪带雨滚地贴水漠漠点缀萦砌南陌蝶扑飘繇别情飞似雪迷莺过翻轻雪扑人随风蒙蒙悠扬穿帘东邻蜂粘撩乱离思輀如绵送蝶飞送落晖随猎骑穿绣帐拂朱槛粘歌袖回雪有风为萍逐水章台街飞绵飞絮飘去长郊扑离樽扑珠帘飘绮陌恼客舡落梅无笛作絮沾泥灞水桥边如雪如霜飞来深院和风三径雪南浦伤离绪轻轻粘乳燕蝶惹依芳草微雨一池萍长亭点客衣故故扑征衣蜂粘过小庭
榴::庭际笑日朱夏翠萼绿蒂园中烧空薰风丹葩丹须晔晔歌槛绿叶似锦叶繁蝶戏意态槛内猩血剪彩欲热喷火照眼青叶煌煌倚薝红苞如霞花密莺穿风光头胭脂烧枝将然蒸霞染云绿丛翠幄衣皱新枝千葩浅绿裁绛绵红喷火愁烧蝶相向背产于西域蜡珠攒蒂红绡裙香晚萼万朵深红蹙红巾绿生烟惬隐乌互低昂得自涂林龙烛敷荣绛帐初迎色染猩唇蝉珠攒作蒂绛艳然千炬如何钟国艳黯绿攒轻叶妖艳烘朝日绣衣乱搭香飘鹊尾湘彩剪成丛红裙撮一行犹自秘天香天红结瑞房繑红衬晚霞宿露低莲脸晨光借绮霞
槐::夏日千亩幽庭残夏庭边蔽日点地蜂采浅翠叶密夹道秋风百行古道早秋园内屯云随风蝉鸣深黄阴浓临庭画聂静映公庭幄书影笼青禁细叶笼芳蕊色被枫宸遂片片飞残菊夜舒忙催举子衣秋香拂紫宸柔阴染淡金光浮驿路长轻轻落碎金
桂::玉犀金粟轻红古香状元清芬异品嫩蕊点缀月夜异卉仙骨偃蹇亭前枝头洁白寒馥仙友异种清香灵姿芬芳秋天清香天香连蜷岩下叶底轻香碧玉枝排金粟非凡种取月斧香飘十里小山招隐太液池边叶成芳堡淡白黄金蕊散麝脐无此香拂檀尘景占三秋中岳长生平原庄丛是芗林花开香世界金花香簇簇叶密千年绿披怀清露晚一枝才放萼影上玉栏杆玉叶密层层花开万点黄遇赏夕岚阴十里已闻香浓艳清香万剌经岁遶槛飘宇宙影散银蟾窟借月延清赏影摇金殿外人间千树少四时长春成丛照山河根盘玉兔宫凭风散异香香放碧云中天上一枝多
水仙花::玉骨仙骨梅后玉止轻黄金皱轻盈皎素玉盘雪貌银蒜冰上冰肌道装桃前冰肌淡白雪香洁白幽妍金盏冰心瑶簪江中似垂条灿红葩欲仙浆七宝贮恍凌波女素兰为友若斜插守素质兆吉梦六铢轻疑捉月仙梅花是兄
鸡冠花::似斗欲飞丹砂欲鸣对立赤玉紫冠带雨引睡露滴丹心独举疑起舞金凤顶数朵红中元竞卖雨过抽英黄钿临风昂颐风吹朱顶无言讶飞鸣紫丝头千枝翠霜后争雄风来摆蕊满头欲白不凋不落笼烟何耸耸低垂如啄食风摇形以斗逼真归造化似斗还无力洗手犹鲜非剪非裁泣露更团团高举低窥笼雨重势将鸣任巧即雕剜如鸣只少声
莲::朱华云锦绰约亭亭矗矗红衣瑟瑟不染红坠粉解语五沃红腻霞标轻盈冉冉煌煌翠盖田田弥鲜白羽飘烟通仙千年奇姿绿柄数茎异萼北沼映水隔沼绿盖芳萼清香映日绿波湖内水国殊艳黄心千叶仙葩西湖发池凌波红幢香苞妖艳临风白浪池中江乡鱼戏丽质雅艳如拭西子面妃子步开国色依水绿山淤泥百子房碧筒酒龟窠芳姿幽香相怜水仙衣越女歌妒宫映池红濯秋水六郎面玉井盘如欲语凌波袜叶舒圆盖鸳鸯同睡听双蕖怨田后夸浓艳一川烟漾水出尘夸国色不胜娇织锦裳花绽长簪翡翠相从题五字篇波神护晚芳十里锦翻风映水照宫钿合开秋水簇成红锦绣半湿浓淡霞光坠冷烟开破碧琉璃斜欹态卷舒芳苞钿扇淡薄绀叶素质琼萼淑气玉冠轻盈素房清香玉葩露濯如霜水仙月上银橐韵幽凝雪色移琼佩鸾窥沼罗袜净宓妃过洛风摇似玉素女波心玉簪香远照波光坠玉杯麝裂脐缟衣新李白临江广寒宫殿盈盈玉洁巫峡梦云水姿合露彩月自云中坠波净明蟾泛清香满沙屿姑射楼台冉冉风吹洛川舞雪玉色蘸波光珠从海底浮烟轻素羽摇冷艳照秋潭半开琼蕊侧初出玉簪斜露冷啼云散残衾香薄秋风冷宵露重鸳鸯冷风闲翠扇风凄短梦霞收色悴扇影寒晓天寒暮寒多翡翠寒云湿红衣溅裙无限水香消空寂寞新袂几多秋颜败半雕残二女并妍并开同茎向背并蒂开楚楚两妃分艳相倚连蒂低昂同枝争放亭亭同干一茎连理香蒂擢秀引翠为祥争笑脸双乔花都无语如对立香共散两枝两影分葩芳心垂芳分红呈瑞并愁容二陆魂各自香欲相扶蒂相连双姊妹碧障竞开照波单柄翡翠双飞分阴相对折楚实呈连璧日分双蒂影水面骈肩萼两神仙红衣相对映日双葩鸳鸯并宿并蒂一般香吴姬笑倚肩风合两花香波心连理枝岸上红袖湖上长歌金浆花钿隔花语笑谑藕花漾楫爱花远船中兰舟洲边短棹湘裙画浆凭船歌误惊鸳梦回船愁恨深烟垂极浦色闻唱怜波静莲香隔浦渡日落半江阴香坠玉簪荷美满江鲜暖折委质乘风晴开倾心依日
荷::盖水绿净为衣碧圆玉立摇风张盖凌波龟游卷舒重叠临风和月池心清香点点涤暑珠圆擎雨制衣浮水鱼戏高下团圆映水迎风水面密影田田纳凉连茎散清香翻雨露短柄摇风出池书半卷日中摇翠盖蓝影光鱼浦碧筩聊助饮叠翠浮小叶盖鸳鸯长枝遮日开叶扇轻摇露下拟珠盘香匀逐钓矶紫橐自供吟风来香气远鹭浴青衣溅日过翠阴移鱼翻翠盖欹贴水青盘嫩青叠翠鱼翻万选流地贯朽长短浮波翠盖圆密跳珠鹭浴五铢盈池珠连高低未开擎雨盖嫩茎摇短绿未应张翠盖祗疑榆荚掷贴水青钿小鱼戏初无碍不碍采莲船小叶漾轻圆犹讶叠青钱虚费柳丝穿迎风翠盖欹龟窠亦未堪霜摧浅色香罢斜坠邋遢雨打衣裂影碎疏疏池影横折萧索碎衣雨压余香翠穿半凋雕零风摧盖倾容枯蔌蔌风声圆倾寂寥敝盖难宿鹭随波荡襞衣潮水鸥鸟失依楚客休吟莫藏鱼逐水流坏扇摇风龟鱼无荫吴娃罢唱
菊::翠叶黄英满地消灾点玉玉蕊紫艳寒英幽香傲霜紫蒂彭泽东篱重重叠玉遶篱愈疾浮金金英黄花晚节佳色浥露黄葩樊川西院叠叠攒金异品千里独秀繁葩篱下露滋秋色玉露曲槛食蕊蜡剪三秋景金钿翠殊芳一簇孤芳浓艳阶前风折疏烟金风疏篱枕花金凝九月天羽毛黄青玉润重阳节得真意沾春露陶潜摘金饼厚霜葩细食惟有屈秀比三花九秋将晚碎金香五柳家制颓龄傲秋霜屈平餐玉楼重露蕊鲜爱孰如陶名高五美三径未荒一色侵阶翠以知重九日最清人爱重种异成孤秀子美诗情重五色中偏贵未觉秋容寂千枝满槛黄故放两三枝乍见蝶凝情香清殿众葩渊明酒兴赊千花后独尊犹存晚节香月朵雪彩素质冶艳繁花清艳洁白似雪月下露浥瑷英迷淡月风茎冰姿琼英幽香景色冷香清奇凝霜篱边风吹玉蕊妒繁霜寒冰洁风荏苒秋兴色寒侵素面不学金英霜凝叶上冷彻幽香香飘风外别白雪香月徘徊水为神愁染芳心试呈玉蕊露下篱边光摇清影影到月中凝黄昏迷月色雪萼风飘素霜封光莫辨仙人披雪氅清晓失霜华琼枝雨滴酥蝶缀影难寻素女洗红向夏开为嫌陶令醉先秋发来伴屈原醒色变蝶愁昨夜零落蜂犹采休嫌今日得失片时过黄花青女节香衰蜂懒今朝萧疏蝶尚开已谢素秋荣枯一岁伤绿酒白云期数朵遶槛可爱三径叠叠妖娆几叠黄凝重重金色重蕊叠金无尽千重成丛堪观重台层层剪缀数重白缕叠叠麝香浓花藏香有余清香非一叶浓艳有千重雕翠傲霜残香落英零落有色委露风摧蠂怨雨打落黄委翳衰色残叶阑珊余香摧霜雨折蜂愁风吹滞露数枝篱下香寂寂艳难迷蝶一庭冷淡蝶意虽还惜傍篱披暗绿阑珊陶令宅因风满地阶前色凄凄枝有傲霜三径荒凉人心自懒观委地乱轻黄寂寞费公庭晚雕霜凛冽细叶雕轻翠晓逐露披离圆花落碎黄援蕊玉质盈掬摘彭泽摘来荐蕊明诗眼旧滴人频易食英金精满头归灵均嚼罢看花长道心轻香酒暂随封花陶令节餐蕊楚灵均
花::风磨阴阳日烁点点似铸栏畔美丽黄深误拾舖排雨洗造化烟滋团团成丛园中鲜园香重难穿点厚重名贵天地炉如新范三品上子午分时如汉三分色好非徒草翫赏懽无限轻圆价高造化工不济贫五铢先阴阳铸出似秦半两名存不济贫栽培兴不穷苔痕何足数虽非良匠铸赐来由白帝榆荚未堪偿还有化工栽铸就本金形玉树翠蕊金粟雪英刻玉奇香琼枝奇葩翠罂琼树飞琼异品辉琬琰堆玉盏千点真珠瓣带淡黄灿珊瑚插银花一环明月枝凝寒碧蠲忿夜合垂丝擢锦白晕绿叶合昏朝披对叶披香红茸朱华叶密清馥雨多凝濯锦叶密烟蒙火红开杪秋月白露滴不死不惭苈草润枝柔丰翘风散似分枝低绣拂翠合欲昏天凉风吹更鲜独擅尧阶鲜剪裁细叶彩襭迎风研丹种玉空阶下骄檀紫四边密叶青节如裁斜倚细丛点轻花绣纹笑日染粉刻缯细雨中妒菡绯一簇繁英绛花似画冷摇疏朵枝弱三分细高低俱有叶幽花不耐雨花匀五叶圆深浅乱分丛幽叶却宜风
梅花::冰肌雪骨琼枝竹外带雪传春雪萼玉骨冰魂玉蕊头含烟破腊霜葩烂熳清香素面冷叶洁白疏影花魁雪香疏枝搜诗横枝舞烟含情水边清奇幽艳芳姿疏花馨香暗香春信冰艳小萼索句冷蕊映月照影篱落月地紫蒂健步倚修竹溪桥晓何逊诗伴松篁偏宜月冰蕊细迷草石驿使一枝云阶绿英巡簷伴长松江路春广平赋笑桃李不待风月波凉出风尘园丁二本点寿阳额艳曲歌成孤山处士点点凌霜瘦冷叶轻裁玉水遥疏影瘦风送清香去开玉照堂罗浮梦断萼绿仙人疏疏傍雪妍寒梢细点琼风送暗香清禽窥素艳来色连千嶂月东阁共吟笔香散一帘风西湖豁碎肠映雪十月嫩蕊深雪乍折岁寒寒薄雪里凝寒一枝新香前村新开春信香飘月中无双品三冬景三五叶腊先破香更远雪未消动摇腊信腊雪未消瘦同杜甫第一春百花魁一两枝春未来影还新花先发勾引春情暖风才及高伴袁安未经三日后岁后无寒叶未春先蓓蕾人心皆共惜一夜忽开尽偶同佳客见先占百花魁风前有晓枝迎腊已芬芳天意不教迟百花犹未知似为早颜开映雪艳态酣酒绛萼芳艳绰约色丽醉脸烟外绛英胭脂红云轻晕施朱丰肌饵丹红葩清香妖娆番奇朱唇江南红萼蜀锦绛雪嫩红丹换骨霜压翠胜桃杏含春意偶作小红天与清香酒阑晕颊日烘绛脸认桃无绿叶酒凝脂脸增红避冰霜诧异香尚余孤瘦人怜红艳睡起留痕露洗红辨杏有青枝似知嫌素质嫩蕊融红雪照溪如濯锦特地为浓繁葩剪绛绡隔岭似流霞腊蕊清姿嫩色镕成似画雅淡金英绿萼清香裁就如鲜明黄金萼姑射雪托梅兄袅荳蔻巧孕檀心玉粟圆雕山麝破脐春风未觉烟滋疑尚润碧玉枝汉宫黄先兰友染酴醾娇开磬口金章细著蜜蜂运翅汉额新日照讶将融芬芳添冶艳花裹重重叶色冠黄昏月肌嫌温玉白返魂都变白蓓蕾带微香枝头点点春香随淡荡风爱淡金黄涂额淡施黄点碧早芳画眉清绝临溪仙袂染碧应厌椒红香泛黄昏青鸟不来倚竹额洗黄尚嫌藓碧寒生翠袖翠娥低蹙飞空疏影拂地琼碎片片满地余香凌波玉消纷纷结子随风飞琼羌笛粉褪飘零无人赏回妙舞香犹在朝云散千万点飞花舖地著地宫香消寂寞似雪飞冷香魂粉半干暮雪飞两三枝玉骨欲埋飞飞怨羌笛辞柯青子结随风犹带白弄玉凌风舞色与香无价寄使虽无便月魂潜断簌簌点征衣著地绿苔肥舖地更余香飞琼冒雪来飞知雪作团调羹会有期踏雪穿篱扶笻竹杖岩隈竹外忍冻嫩寒春早短篱江畔穿兰迳穿云渡水挂片芒鞋岸侧溪边寻香清兴诗新曲巷山巅过竹桥携酒去寻春信和雪折山前山后云横陇首难凭蝶使为寻疏影久驻青藜杖为诗寻踏碧苔倩杖扶枝北枝南路入罗浮独跨驴来独立嫩寒频看白雪枝素艳含春早湖水孤山侧雪深难辨色清香报客知石桥官路旁风逐易闻香江表和雪新春春信逢使惜春温陇头置邮故友交情寄人清冻色雪精神随新意聊自折檐头冷蕊一枝玉蕾风如送信人行千里外驿使频回首冰骨格想旧容为君封风外清香千里筠筒色不沾尘春任一枝中情人几断肠古道今时少寄使虽无便一枝春欲寄玉蕾随新句交情岁晚同调羹会有期千里路何长筠筒入置邮槎牙老干寂寞古拙楈柮蟠根萧条横披江头残枝骨立貌枯经岁月雪后冷叶皮存神泽历风霜
桃花::不言裁绡红萼雨濯灼灼红葩紫府无主剪锦芳心烟滋夭夭朱脸洛阳红艳照水照日无言微雨烂熳溪畔翠幙枯萼武陵发萼成蹊丹唇芳姿临风映霞似笑暖风妖娆园中华池瘦红唐苑生春满县红脸村落凝烟玉佩淡红含晓露蜂蝶使微醉日无双艳色俱好通仙馆日休赋仙园映日茜裙疏影笑春风绮罗丛渐流霞第一花艳不同类浣纱禹锡诗乍雨乍晴施朱施粉一种天香青花万岁佳儿水廾页面有意娇春态脸湿含春露带雨深兼浅半开半萼倾国倾城十分春色白叶千重妒女专房多情上玉肌唇红笑暖风和风绿间红腮红销宿恨枝间留紫燕酥胸酣暖日脸嫩助新娇叶底发清香霞脸笑春风上苑露浓叠锦点缀倚栏助娇仙源日暖堆霞剪裁笑日销恨浓华叶大奇花叠翠红灼灼繁多艳摇青玉相掩映高低绿香腮润饶异品妖艳花奇碎叶堆红翠重重点缀功叠绛纱乱交加烂熳红嫩面红一般春柔枝袅袅老干柔枝烟笼密叶叶攒翠幕碎红非一叶落花霞片片碎叶虽难数碎叶夭夭芳姿劲节露湿奇葩花发芳枝嫣艳有千里缀叶锦重重奇葩自不同照野千枝翠争春万叠红直节绿枝绿问交加笑脸比君渭川助娇修竹含轻粟芳姿绛萼红交掩映虚心丽质仙苑堪赏碧桃晕浅红淇水绿慕高节深兼浅千亩秀散柯布叶淡深相隐映含烟多翠色武陵红伴仙郎绿间红几枝春倚翠偎红红绿乱交加映日更红鲜
杏花::问梅遮柳活色枯枝野店孔坛丽色绣野艳红南陌赏客红光翠艳红脸鲜艳生香碎影山林唐苑红颜烧林娇翠午桥酒徒紫艳芳枝绛唇芳菲蝶恋丽色美色轻风红影碎凭暖日映朱簿焕蓬莱碎锦坊压玉栏超群卉鸾迷余香闻香微雨绿阴繁倩晴霞裹绛纱灿东海含章殿映丝柳占上林欲红还白冰绡轻叠武功山下插帽盈头叶细春阴淡影媚游春客万叠轻裁锦露粉凝脂绛蜡潜凝董奉林中探花游目花低昼景浓香飘卖酒家千枝烂拥霞深红千朵秀绕园看锦帐一朵铺文锦淡白几枝匀夹岸衬红云千枝叠翠霞半吐柳外羞暖浅白红脸浅枝头怯寒深红朱唇含春暖竹篱静春方晓半红随酒旆怯晓寒山店幽日正迟微白出邻
梨花::素艳清艳潇洒冰肌雪态剪雪带雨露浥洛下蜂迷一树一枝清香淡轻盈玉骨玉容裁冰摇风烟笼郭西蝶采千株几片霑衣清艳素色冷艳冷淡清色院落缟袂清艳粉淡高低翠叶堆金带雨浓香清姿靓缤纷浓香亭台琼肌暗香香清远近青英叠玉溶溶月红处白秋千地月添白浮雪润梅共色冰魂冷压树白云水仙态度淡淡风冷时香蛱蝶来雪未消夺玉光月为邻雪色新暖风晴雪青女精神白雪含香开花尤洁白一枝临野水吹香风有信靓青蛾妒一枝春带雨笑从风外歇碧纱笼素比雪更馨香数树出江村弄影月无痕光凝粉蝶羞万萼雪凝肤啼向月中来夜蟾同淡薄晴蝶共轻盈
海棠::蜀都修条娇红春睡红锦绛萼露蕊争妍红影照水唐苑腻叶美艳晓绛霞红腮烟梢如画香风含烟绕园窈窕烂熳睡思著雨唐胭脂锦帐繁红秀色烟愁绿肥艳翠夹岸娇柔妖娆醉客笑风蜀锦猩血绣衾秾艳名葩雨泣红瘦妖红高低馥郁风前丽质紫锦香销骨千点赤迎日丽锦鸡翼神仙品佐黄花深浅芬芳烟芳容红萼醉入肌半开红带风开彩凤楼命妇花笼蟋蟀欣有色西府嘉种锦帐横陈卷帘侧卧雨濯吴杜陵居蜀海桥题柱梦中花蕊恨无香南海芳枝红云尽吸烧烛斜窥风吹蜀锦罗隐游杭药肆登巢诗内锦鸡日高春睡足妃子眠犹困含烟凝媚色锦围春照耀胭脂匀欲滴盛若霞藏日露冷晓迟西施酒半酣带雨经微红红雨暮烂斑紫蜡带何长鲜于血洒红强名层层幽姿娇娆垂丝仙姿花下一枝彩霞风卷绿仍春醉不类袅袅淑态袅娜剪彩幽恨梢头数片红雪酒添红欲晓霞千点郁郁苍髯懒无气力剪彩层层横陈锦帐初酣晓日天开锦幄红线千条幕锦一机丝丝红萼睡起精神轻丝袅袅尽被红云晚笑东风日照红檀心一点圆低带流莺睡艳宜新著雨狂和舞蝶飞娇在欲开时
稻::炊香雕胡翻匙淅玉瓜穗落杵香粳流脂雪花玉白十月获流匙滑天风热和露滴稻肥黄俯首落杵光辉白玉粒炊玉云子云黄五里香落杵新云水寒带香炊芒动紫掀须除芒子粒红春风针水绿香稻三秋末秋露卷云黄平田百顷间
麦::坵中珠颗黄穗盈郊白雪碧浪轻花韵鹂鸦种桑下金茎白芒满野黄云香穗荐鲔雉娇色秀渐渐夹道锦里山坡贻麰两歧浪色灵苗歧秀荐瑞翻绿浪连天绿花轻蒙蒙满畦崆峒村陇播种九穗云容秀穗农登呈祥烂黄云匝地黄连日秀陇首烟迷兆应丰年波摇净绿柔茎迷小迳点点和烟乱雨余轻染碧浪逐风前起逐风清坡腰风度祥符治世露滴娇黄绿叶绕长畦纷纷匝地平风过细翻青花从雨后开凝风千万垒浪卷千原涨积翠两三波云铺万陇平雨后含青卷地青青连天远青连野观漾碧风前流翠滔天艳艳卷地流绿满畴拟拖蓝尚无鸥浴东西竞涨阵阵吹来潋滟翻晴日鸥鹭疑应下随风舞南亩沙鸥不肯下唯见雉媒上下倒流层层涌出苍茫涌暮烟蛟龙误欲潜浥雨涨东皋野雉竞无眠万顷光摇荡粼粼翻落日千畦势渺茫滟滟涨平畴月村雪卷珠翠千顷波光香犹嫩晴荡日霜圃沙平密香一川月色粒渐稠冷涵秋纤茎珠碎蜂喧细径旷野波平蝇糁纤枝
蔬::紫菜绿葵霜花霜叶雨甲幽居青嫩晚菘联畦青甲知味柔簪露柔蔬白薤风叶露牙烟苗隙地紫腴早韭覆地翠茎和羹玉体新充上品露滋重叠雨后叶新正方畦画局芜菁青甲嫩烟丛青夹径惬常情雨过参差春前茎嫩微润土融酥香韭翠茎长雨叶绿凝畦
芹::碧涧涧中青泥坊底献去采人琼出何日种献芹情小小多羹虽可美堪为明主荐采来学士玉本一时生荐藻意区区献御固应疑亦表野人情
韭::农本夜雨剪春蔬炊饼成露何稀强欲击东比青刍色园齐玉箸头
果::干为结实盘荐秋庭紫房雨濡祝君齐结累累擘来盈枝明珠滑解折烂枝粮充夏圃朱实风落奉客同荣颗颗嚼破亚叶绀玉香尝朱实涵秋水李沉玉甃篚实韩公朱实烘晴昼剥烂文将画团团枝缀蜡冰盘簇珍实荐绿香抹夕阳瓜订冰盘市盈潘岳香苞傲晚冬干冬物自荣颗颗手拈珠绮席荐霞觞红绽梅初涨昔作山中玉黄熟经风落黄传杏半垂今为席上珍青垂藉雨濡
桃子::玉岭浓华露井烂枝仙果颗颗压枝霜园甘实仙原和叶琼肌株株满树美味仙根紫文酡颜红腮七枝朱粉雨染十洲地能变化宽容十斛甘津蟠实细核醉脸紫颊千载琼璠烟蒸半片形可长生重过一觔压枝星坠王母献来凝烟肌带露九夏曾经赏颗颗霞媚雨染千枝重仰攀东海实和叶露晞东方偷去映日脸红千年祗浪传团团带露肥烟蒸万颗垂共燕武陵春方朔名成在刘郎迹已陈
李子::翠质东苑甘香傅粉咀液霜肤带露枝重枝头摘来青皮上林碧脆施朱攀枝碧实临风粉干叶底尝处紫绿鼠精连理闻香玉叶金弹颗颗能驻色连枝重肌团玉叶暗低垂槛绮青龙耳如瓶和酒冰盘水晶离离莫整冠绕齿凉脸带朱枝繁重压墙瓜绿甘为伴碧脆盈盘俎水底沉寒玉潘岳闲居日伯阳因指姓桃红愿卜邻甘露绕齿牙盘中叠绛囊王成戏陌辰李广漫成蹊
梅子::和羹带叶止渴连枝白花压枝一斛细雨丹肤红绽圆脆岭上春生圆熟带叶实垂磊落紫蒂映日满林薰风醉脸黄肥甘酸头夏熟清香连枝色烂横斜青青颗颗叶底和叶重细似弹能明目雕篮试巧日红半脸江风表信黄似经霜熟楚楚累累枝头压枝低重如金有同心银碗求易露湿片腮夏雨时行红如带雨肥尽从风熟七实连三实繁枝凝蜜蜡枝头黄似玉偏向雨中肥南枝对北枝标实破苍苔叶下重如金
杏子::风吹雨后颗颗几珠美味日照风前青青千颗清香匀圆红脸叶翠酸味烟薰压树黄似橘枝枝密盈林翠五沃含滋红衬金盘美露绿肤腮红坚肤雨濯盈盘大如梨颗颗匀半脸红三元表异彩悬蓝水孔圣坛前奉诚园内落园不取不随李绿桃肥同缀碧青腮翡翠鲁坛直味在董仙林光武陵旁揉汁能尝且斗梅黄梅瘦共传黄丹脸傅胭脂梁苑旧风存
梨::汉园元圃似密珍果解醒灵关饤坐甘香玉润玉质真定离离果宗张谷青田如拳名园消渴大谷封侯津润珠悬云腴广都落落秋实手拈清香甘若蜜琼为汁醒梦寐清遶齿太谷佳名袅枝粟玉盘堆削玉甘香珠蜜冷齿嚼奇品脆如冰玉作肌破醉酣爽充肠仙都灵种慰齿春冰齿返流泉脆美玉霜阳味滑欺萍实剖轻刀力快冷宁思露掌凤卵辞丹穴色鲜因晓日遶齿琼浆冷香清笑橘奴嚼易齿牙甘寒切饮冰壶龙珠出古潭声脆得秋霜充肠玉液凉
柑子::金苞平蒂经霜万颗三寸磊落累累一苞金颗携来清香金衣喷雪露叶蜡蒂圆宝映日几枝千顷累垂颗颗千瓣玉浆摘去玉液珠实垂珠霜枝玉指擘开琼浆霜落实超玉果罗浮种披露叶侵齿冷累累实随边使金盘嚼破金瓣香喷人若金珰洞庭春擘霜苞入心凉瓣瓣香戏金门摘来盈袖枕畔冷香风翻玉蕊青黄映篱落垂实连朱户时多香不变压枝金颗垂尝处益牙齿边余味霜染金衣的皪照汀渊交柯压粉物外味尤佳遶齿玉浆甘秋后经霜熟来助杯盘胜朝来带露香羞将橘柚偕
橘子::赐臣白华霜林美味累垂湘水云梦星耀遗母朱实露野清香磊落扬州洞庭珠垂金色薄皮凌霜珠颗霜浥浪围层枝晚岁象合欢四老绿叶建春山玉浆丰瓣冒日琼浆露蒸风撼剡棘密林仙井共蒂千头素荣蓬莱殿经霜肤腻皮腻黄金瘦布影临丹地苞垂列星纬乐事传商岭昔随淮枳变带露肌柔肌匀白玉香飞香度碧岑味变九霞浆题书寄洞庭应贡禹包珍圆清香小佳色金弹珠垂水橘金衣清香颗颗风餐溅齿错落色重入口仙子丹砂奇姿蜡丸星灿金柑蜡弹色秀圆圆露饮可人参差味酸供筵王孙金弹黄欺晚菊香雾喷人颗颗垂金弹轻烟笼绿叶实重金弹小地簇鹅儿染圆小枝头颗圆并明珠清泉遶齿枝枝缀蜡丸红日映新苞味蕴玉浆甜天成蜡样清甘舌上香
橙子::圆实结实鹄毂映日刳肠金虀饱霜黄金卵同橘柚香不去金杯软分开清香犀纹经霜分核玉液和露翠玉浆胜楂梨味微酸玉指香星攒翠幄剖开鹄卵清霜夜漠漠结实黄金重一年夸好景鹄毂攒修干露湿金衣来酌仙浆佳实晓累累分开白玉香万颗散清香金华耀晚曦
柿子::朱实红星虬卵经霜碧蒂金衣含津丰肌凌冬嫩红星灿低亚枝上凝霜垂枝重牛心映日红囊火伞散彩佳味缀露脆绿霜凝玲珑道旁透日间叶鲜千颗熟新带雨星影出千枝翠累累熟八棱枝上晓连星影玉树婆娑圆颗迎风熟几枝红饱经霜日光圆数颗红颗颗干七绝林中晚带月光金丸熠燿朱苞映日鲜绿阴连路暗味胜金衣美红实压枝繁甘逾玉露清
枣子::鸡心赤心安邑露濯垂阴细核日颗离离羊角丹脸信都风摇布实弱枝风枝纂纂来来牛尾五苑鼠耳素华皱红甘辛异种甘如蜜和烟细红映日藏密叶攒攒尘卢千林牛头朱实骈白磊落嘉名大似瓜带雨鲜翠含烟出高枝少君海上外炳朱丹彩曾子思亲嗜后期千岁熟旧名稽药录甜出诸饧上今作中州瑞王吉庭中中含赤露滋王孙去复还今见万珠圆新实著诗篇香居百果前原从外国传
栗子::汉苑日晒紫壳华林嘉名南安侯封霜苞山卉百刺数树华山麓秦园风吹苍蓬汝水异果北朔拳实猬刺席珍千苞千枝汝水湾颜甑晓蒸祖心待赐庙祭充笾豆中黄玉比质包刺如防患朱夏滋荣月庄灰夜裂女贽通传宾筵对酒卮外刺芡同苞双肌似合欢清秋结实时
荔枝::烂紫轻红火实玉液丹壳珠颗虬珠锦肤露叶液甘珠株一枝星缀绛罗锦壳琼浆金丸玉肌玉浆猩壳琼液风枝颗重霞树万颗珠排水弹琼肌文壳皱蒸雾雨丹绡壳三山下烘畏日壳皱鳞消内热生处远千品色仙鹤顶寸珠圆傲霜风白玉脂万水先带薰风瓤包玉濯中干摘来稀一枝春水晶丸金盘摘下绿幄翠笼紫琼骨格左思赋咏一簇水蚕茧赤蚌遗珠颗九畹依兰友红壳开时绛囊包就白雪肌肤王逸揄扬千苞火凤冠红犀露角端千头使木奴隔瓤银叶嫩始因风弄色烟雨万珠重透膜玉浆寒渐与日争光尘埃一骑劳
龙眼::薄皮迎日芳实繁实万颗离离小核缀星圆苞殷红千珠颗颗星缀味美仙鹤顶星陨空红裘小红壳圆匀冷透水晶润包甘露液冷透红绡膜珠排芳鲜水晶丸珠还浦白玉圆香肌莹彻香生甘露团裹绛霞丸香凝白玉肌嚼疑天上味嗅异世间香
橄榄::霜苞美味修枝厌苦苦涩翠阴解酒真味渴处投异茗翠颗芳鲜异果回甘珍奇青子供茶余甘醉时落红盐酸且苦一味爽些子涩消人酩酊词咏坡仙翠颗先磋玉新香资解酒始尝虽苦口甘若饴十分甜十分香共客徘徊曲传乐府青肤巧缕琼甘液助烹茶终美是忠言
银杏::小苦去皮玉骨鸭脚入贡玉碗盘根厚青灿烂绿经霜白外皮深绽绿微甘剥核琼肌鹅毛可珍金奁结子迟白玲珑坚见火松中核浅含黄鸡头休并美去皮伤嫩绿肤厚还无味龙眼莫争先剥核取新甘实微别有香
樱桃::二株三种细叶磊落并蒂蜡珠讶火鸟啄珠连万颗晓日簇簇颗颗的皪素华红葩光明连心崖蜜如珠莺含星灿千株薰风垂垂累累玲珑朱实火实叶翠倾盘猿窃柔质匀圆红蕊和杏酪千万颗充凤食轻解破明珠滑星珠实红出袖蝉鸣绛皮润滑绿枝含蔗浆两三枝许莺偷软含消绛雪消先诸果风留紫脆摘残丹颗戴氏荐祠樊素妖檀口日烘红似火琼浆酸甜足奉五侯日美红阴嚼破红香汉家严庙真妃点绛唇露洗灿如珠金丸大小匀驱禽养得熟猩血和琼液和叶折来新蠙珠荐玉盘
胡桃::刚皮入贡坚壳柔脆皱壳形朴种从西域柔质远移薄皮坚刚甘瓤性仁栽自华阳实成千岁外怀刚烈来路名虽异嚼处香还细风落九秋内蕴柔甘甘多味更珍藏时形更坚
石榴::紫萼千房玉润红玉玉液花红似火皮裂圆熟夏日解醒磊落园中丹须万子星悬丹砂金房子白如星子解甘酸秋风止渴累垂林下错落红肤半含扶疏千条翠枝枝弱排玉齿紫莺栗胭脂脸雾谷作房烟滋黛叶清甘朱实忽绽磊落百子匀个个红胜天浆红瓤房红绡肌水晶为体露裂星房试剖紫金碗红肤疑莹玉实垂悬玳瑁子露佳人齿西域移根至花开当夏日满堆红玉珠素粒类明珠皮破吐珠玑肌匀美女腮南方酿酒来齿露自秋风
杨梅::枝头火实颗颗龙睛绛粟猩血轻酸味美朱丸小绛唇嚼破味比葡萄叶底星珠累累鹤顶丹砂凤冠微湿色鲜赭弹圆玉指拈来色方荔子火齐烧空绿阴翳翳如珠繁缀树摘下珠犹湿似笑樱桃小止渴还相似水浆凝露丹实垂垂似火乱烧枝尝来味带酸堪同荔子丹和羹谅亦同
木瓜::清香经霜美味红脸切玉嫩色著雨微酸青肤传脂露浥无味轻脚膝入药品金刀分来味涵玉液张说献来香肤凝碧玉露浥枝犹茂霜封有香报琼琚见苞苴衣奁藏处囊蹙金砂神农收去腻脸讶红香霜封颗更香
瓜::龙肝坚肤秀润金刀冰谷邵圃水晶虎头青门嫩馥春播刀分兽掌甘液清甘玉井蜜房孙园苍玉鸭顶缑圃甘腴夏成齿嚼五色破霜浮水粉瓤拣肥遗母北冢肤坚清冷堆盘实如玉色香发越盈盘浮玉嚼冰玉瓣代戍授官东陵味美甘润透齿凉似琼浆翠离披二茎十实苏井筠笼孙钟种后带露摘来遇畦休纳履齐国当年戍冰谷分新种朝采暮生金刀玉手曾子耘时挥刀剖破报赐好投琚东陵旧日名炎山忆故江刃分金瓣小绿团罂一搦藓甃开冰段齿嚼玉浆寒白裂玉平分梅山失火云
西瓜::玉质黄花解醒斗大绿肤青蔓挽难断冰浆绿蔓慰齿冰寒白心白花畤可观浸向胭脂井削月鹿苍玉润露别青丝卷秋圃携篮重渴消金爵醉堆宜玳瑁盘落齿水晶寒霜封碧玉团冰霜慰齿寒凉沁玉鱼吞
葡萄::酿酒一架繁实荐新千珠柔枝磊落龙须繁枝蔓引千条紫乳日晃上下片片夏褰枝上碌碌柔条凉润蔓延马乳浓穗架高万穗绿珠风吹累垂累累秋摘梢头累累佳实甘寒缠枝消渴赐臣堆枝上连碧叶秋结穗金刀剪垂晓露甘同蔗味架合青帷满架解醒遗母引架长结金裳露凝浆玉盘承熟秋风美似琼浆盘堆紫玉瑞日晃时鱼鳞含宿润九月霜前熟露垂珠颗重满架连绵盛条长翠虬舞甘泉润处马乳带轻霜三秋雨后鲜日晃水晶明长条烂熳垂叶重绿云频
甘蔗::石蜜糖霜甘饴挺挺解熟愈痞疾偶然存荻蔗佳境棱棱凝寒析朝酲幸觉对松筠
莲子::绿房枝斜嫩房冰茧戢戢凌波堆盘紫菂柄侧新实露房垂垂带露走珠坠粉清房红衣金塘青子肤白圆落清香素芙柄柄蛙胎倒垂照浪捣霜圆颗翠菂玉井绿苞心清玲珑甘液绿茧团团鱼眼中挂惊鱼脆美垂青茧绿盈盘轻轻刺仙品湿波照熟香通玉陇刺分玉蛹薏剖香心芬芳侧翠杯香溢齿个个同蜜脾香露漙滋液涨华池嚼破冰丸丝牵绿柄茎垂琼盏侧肉嫩山蜂子绿垂蚕茧实花谢红飘水尚连余叶在半分青钿盒子绽玉珠圆棱深天马蹄红散蜜脾香房新绿映波深映乱蓬低虚挂碧蜂房
菱角::紫苞利刺怀珠莲裳露头角驯象露牙头角峥嵘甚青角纤茎蕴玉荇盖济凶年潜龙献爪肌肤冰雪多紫衣为映坐花生秦镜罗袜解凌波鸟去越歌中
藕::素节众窍粲齿素白脆美琼肌雪肤雪丝丝绕污泥纤丝盈泉玲珑清奇雪志心窍玉节犀通香冷金井掘处冰冷千丝合佳人臂冰骨壮藏洁玉金刀切来不淄原自白味甘玉池折来风高七窍通智士心蜜脾香缕轻丝琼浆嚼破无物故能空芳根蟠绿水丝应蛟乞与盘贮冰尤洁清泉浴泥滓脆节引香泥珠是蚌分来刀侵雪易融粲齿碎冰霜
松::负霜栖鸾坚心霜根龙形贞蕤苍髯马鬣秀岭千尺偃蹇苍苍磥砢冒雪系马劲节雪干盖影秀叶黛色龙盘参天五株婆娑郁郁鳞皴龙挛轮囷直干密密清阴栖鹤翠色坚节苍髯岩中蔽日百丈幽蔼虎跛逼侧浓阴亭亭翠影化龙寒声高枝瘦甲涧底凌云千年葱青号处士如千丈君子操凌千尺霜雪操如障如屏脂凝琥珀径无红叶瘦叶几经雪为主人有百章大夫封贯四时栋梁材似幢似盖韵奏笙篁枝有白云孤根多阅春鹤栖君子树翠盖烟笼密月影龙蛇动叶倾秦帝雨紫茸抽组绶风拂大夫枝花幢雪压低风枝箫籁鸣花老宓妃春青实长玫瑰磈礧周围蹙缩合抱一株老干偃盖新柯几上周围虽合抱日转无长影数尺盘根短材古干盆中直上岂盈寻风回有细声云色虎躩百丈风音龙拏千年枝偃霜老虬枝影疏夹道轮囷风声琴声任危岩增气象承雨露烟叶葱龙叶枝岁寒鹤骨阴薄嵌岩森疏月影鹤影依峻岭竞题评攘冰霜霜皮驳落根深见珀外蟠千古干年深鳞甲厚几经霜雪操影分清夜月鹤骨惊消瘦子落如丹中有四时心风冷雪霜高不改岁寒心声带碧山泉龙姿凛屈蟠玉骨仙风色浓落落带雨细影增青细声本小云根枝柔翠色薄依绿砌初长龙须质弱青青含烟清声倍爽疏影枝蟠露叶叶小月影疏映疏帘永垂盖影未招鹤宿叶小初凌雪草中人不见时影才升砌夜月影应薄渡风微有韵日暴龙鳞瘦稍类虬眠鳞生欲伏龙云外鹤先知秋声未过晓风声渐清印月未成阴春滋玉髓芳清吟淡荡奏瑟鹤语和琴静夜洗心雨过小院戚戚窗外鹤惊舞爽梦萧疏吹箫龙吟惊鹤深秋喧耳风来间庭飙飙庭前龙起眠千山月照好向月中立听时无物乱拂空增鹤唳风前虽偃哑云影乱舖地万壑风生偏宜秋后听尽日觉神清过牖合琴声月下自清虚涛声寒在空
柏::落落苍苍凤宿坚刚鹄立森森挺挺鸾栖止直鹤栖虬龙侧叶留雨四时势老鹤骨霜干茂干拔地皮枯森罗老叶偃盖霜雪横柯经霜千尺形枯龙姿云梢芳姿撑天节劲翠郁危梢苍鳞凌霜深根黛色秀色翔鹤栋梁器青不改经万岁三千丈能傲雪蛇形状映日壮节霜姿英姿化龙龙虎姿绿偏浓耐三冬四十围不关春雪霜姿霜前劲千载老龙应蛰殷人社雪霜不死影度花砖岁月难记色有新故耸壑苍髯古雪后凋四时春鹤更盘卫国舟雨露长涵香沾玉案风霜饱经节无煖寒参天黛色浮金枝擎积雪未同松后老祗因柯不改劲节经千载翠影笼秋磬玉韵间疏钟宁共李先荣解使景深留浓阴贯四时寒声入夜琴灵根一株秀色仙种千岁繁根不老轮囷老干风揉拥肿深入地千年干几经霜雪风霜应久历根株经世久长青苍翠蟠根雨练团圞直参天万岁枝屡阅春秋斤斧岂容侵枝叶逐时新岁历春秋久枝屈神龙蛰松桧为佳友枝柯繁蓊郁却笑桑榆晚恩沾雨露深根因怪石盘烟霞作旧邻根本固轮囷不随桃李鲜
柳::隋堤一绝十围汉苑三眠百尺生肘袅袅万缕垂堤翠色浅绿带雨莺穿御沟风条游丝彭泽龙髯歛容依依千条拂槛绿阴轻黄含烟蝉噪官道露叶飞絮武昌凤翼客舍青眼舞袖章台高下长亭静婉眉细五株细叶牵恨官道千丝歌楼翠眉宫腰灞岸短长别浦娇娆腰纤千树长条送人野桥万絮黄金缕叶如眉翠眉飘绮陌留春色开青眼来蹴踘经宿雨垂金缕添愁色绿丝条花似雪绿腰彩拂朱门系落晖舞绿腰拂秋千逐香尘学步摇换旧条隋帝长堤巫娥庙叶舒暖日岸笼残月垂丝遮阁榭美日黄金色腰为何人瘦陶公旧宅宋玉门前枝袅轻风堤弄晓风飞絮触帘旌伤风翠黛眉眉因底事颦带雨开星眼齐殿风流态凝烟蹙黛眉阳关离别情茸茸缲风绊愁千丝带雨细缕鹅黄风流缕缕织雨萦恨万缕含烟长条鸭绿摇曳拂地萦地堪观经愁撚青掷金线能牵客恨萧疏随雨织莫待霜刀剪细细藏莺语摇堤拂槛入画纬恨搓绿画碧纱长系人心轻软任风梭频烦雨线添垂垂绊客衣莺穿浑若织发生资地辅织雨丝偏软鸦戏已忘机裁剪出天机含烟色更饶轻盈昼永临水濯濯醉眼鹅黄和烟袅娜春初舞风依依舞腰黛色迎煖暖律添愁色黄金缕舒眼倦轻轻钧月鹅黄方乍展顿添今岁恨长条还似旧和风换旧条绿丝条舞腰倾淡淡描金翠黛未全施不减旧年春细叶复迎春低柔轻窣地娇困不禁风流丝赤叶龙鳞疏枝斜日小寒残蝉古道寒渐渐烟淡淡飞絮绿条凤翼病叶秋风阴薄古树长堤冷萧萧雨蒙蒙飘黄叶东门叶荫通衢雨声滴滴暗逐雨声灞岸秋风老病叶因风堕折翠条北郭枝蔚清沼月影疏疏愁随风阵隋堤暮雨寒柔条带雨垂
槐::良木老根浓阴黄花老干蚁动扶疏密密古道亭亭带蝉南柯夹道屯云连市翠影绿叶盘根蝉鸣蓊郁沉沉废宫郁郁栖鸟丹陛盈园蔽日荫涂成屯绿阴条密清阴荫借阴三府叶生驰道侧蔌蔌黄花茂绿荫连天陛叶被宸宫密布列黄萼叶繁绿影摇垂荫百官花落凤庭隈阴阴翠幄张繁阴蔽讼庭花催举子忙列市云屯绿翠叶疑朝露排行雨点黄蝉声送夕阳
枫::江头霜染楚岸余霞聂聂叶繁红霞山寒吴江内渡口风飘吴江碎锦萧萧阴密锦绮江冷蜀道中蓝偏润恍若情霞残叶无留碧吴江波正冷乱霞千万树楚岸收新雨晚节输篱菊锦作团浑如野火疏林半染红蜀道锦成团余绮两三枝吴江肃晚霜疏枝伴井桐
榆钱::漫天叠砌巢鹊点点似铸雨洗溪岸屋下形圆成荚隔厚重夹道满庭鸣蝉盈盈误穿风镕野桥亭前色润辞柯铺地轻飘素质落叶圆殊半两难买佳人笑为欣供静景铺排春富贵团团翻暮景淡烟垂枝薄似三分从教隐士贫直欲买青春点景繁华点点掷轻烟
梧桐::珪叶凤条鸾集三株金井良材峄阳半老栖鹤井上疏影独秀茂叶玉池影直凤翔一叶银床直干冯翊孤生剪圭庭前浓阴特生绿枝琼甃阴浓肃肃挺挺香枝鸣夜雨散清音成琴瑟横小阁先占月惊敲叶月移浓影凄凄亭亭翠叶动秋风舖翠影摧琅玕坠寒砧不禁风忆落花风猎繁声枝森青玉日迟蜂度影叶影乱稠叠凤干千年老菶菶参猗漆生怜不得所翠色洗朝露叶剪碧罗春暖凤栖阴花香疑有无龙门百尺高雝雝集凤凰死欲扬其声清阴当午阶
桑::金紫椹凝阴摘叶环庐嫩叶采妇妇工附枝玉笋丹椹驯雉十亩陌上桑条结幄攀枝蔽影成林农夫蚕食沃叶金刀绿云饿人八蚕蚕月雨叶羽葆儿欢夹道风和浓阴沃若青叶似盖阴成舒青叶制贝锦麦秋烟条罗纨妇喜连畦日暖翠影森然翠条如云椹熟长翠条探金环垂垂椹黑阴迷春雾叶细柔蓝染迟迟当暮景莺春芳渐老必欲求繁叶食椹春鸠足冉冉条青影透夕阳枝繁翠幄圆隐隐起寒烟蚕日务偏长应须伐远扬栖枝暮雀繁绿枝深冉冉丹椹正垂垂攀条满篮园中枝垂逐伴陌上冉冉才晴柔枝雨初霁采叶盈掬池畔指露携筐边芬芬未晚坠叶春正忙求繁叶投林去玉笄樠秦女执筐鸠方啼晓候取斧功仍在柏松非共永茧丝成有待伐远扬截路归金刀裁幽人取斧蚕未入眠时持篮事未休桃李下同时斤斧去何忙越女时方采周人月正条
竹::淇澳紫花故人团圞劲直虚心繁阴风梳停雪霜叶化龙交加六逸渭川翠实君子潇洒扶疏贞节翠色雨洗冒霜烟梢栖凤琐碎七贤戛玉拂水弄月直气抱节傲霜翠笻凤实冷淡嶰谷岁冷百竿江阴横影敲金间松迎风高材成林宜雨斑箨龙孙精神葛陂霜侵千亩溪畔扫尘数竿粉腻风干露涤阴翠朝烟凛凛霭霭迸箨风梢高节比德婵娟一径丛疏烟梢风摇粉娇晚影亭亭青青轻筠月影翠姿宜忧青翠仙石坛辰日种裁凤律冰霜节娟娟净风借润元有节千里好风涓涓粉节蒋诩径腊月栽制渔竿玉雪身细细香月生凉本无心一庭明月袅袅烟梢月送绿阴含风飒飒翠滴清蓝腻月上分清影月缕无瑕玉炎驱三伏暑凤尾摇丹槛露凝寒色负雪猗猗圆槎碧玉长风来弄好音风弹不调琴风送一堂秋龙孙舞翠空萧骚虽入耳虚白自存心红泪丹晕一枝点点露压如洒恨相间翠色啼痕犹在紫纹红斑万点离离烟啼似画含愁若散坚姿哀怨未穷一朝遗旧恨叶叶成愁思枝枝露节劲千载长新痕枝枝满泪痕点点泪痕斑密阴紫色堪观雨痕窗前敲风含槛玉殷色清阴可赏霜染庭下抟日半庭金翠云舒作叶殊声依涧水叶密罗青玉迥殊千亩绿绛雪染成竿真色染朝衣枝鲜衬紫霞别具一般奇劲节扶持渡水助险鉴锵把握登高扶危代劳茂节同出入晨探步龙形瘦凭君助声声响并州作马病躯履地一条能助险借力坚姿共行藏夜敲门鹤膝长藉尔扶步步移葛水成龙衰体临危九节善扶危谩假携持力清怀君子质赖尔扶持力花间村酒旆有节增人力多凭赞助功曲体老龙形安君老大身云外野僧居无心得道虚含箨解甲出抽梢指日嫩叶雨痕解箨阴溥风箨翠干带雨翠梢叶小解甲吐芽开燕尾排云新梢烟色抽芽声清霜根青枝出林粉节枝纤出篱穿砌送龙孙斑初脱初挥箨渐舒凤尾能筛月影节留余箨未抽凌凤节雨箨犹含泪渐解将军雨碧乍长自庇根学作鸾鸣未罢风声梢出旧栏先隐化龙形霜姿半落铅微抽御史簪冉冉偏疑粉影小未遮月谁讶生来瘦萧萧渐引风阴清已满庭须知老愈刚全老槁叶萎折霜欺庭前元耐夏半凋疏枝离披雨压槛外尚欺霜根欲老心空虚风外甘枝老霜欺黄叶陨气不衰形憔悴春来望笋荣雪压槁枝摧袅袅摇风轩内扫阶扶疏琐碎沉沉筛月窗前覆地潇洒参差侵阶密月送绿阴扶疏笼晓日扫月当轩净玉立风前干凤侣依栖少色侵书帙晚覆座凉露凝寒色潇洒布清阴摇风荫座清金摇月下阴龙孙受庇多阴过酒樽凉不须溪照影自有月传神鸣凤素笋绿叶雉头芥樽变蛇朱书百尺灌溉断苔栖鸾绣衣翠茎鸡颈檀栾飞鹊青简十寻栽培带壤乘雨带笋萧骚数竿故土映轩庆重谷开深径雷带至苍龙骨此日孤君用辰临轩支戛半榻新梢临槛扫员池接远篱雨辟成碧虬痕暮年千亩编篱防野鹿清风如有待翠烟来晓色好共芝兰长梢分庭影重根从辰日励开径待佳宾明月自相寻石槛借秋阴无令草蔓侵根带藓痕多笋看上番成
笋::龙孙犊角戢戢稚子锦朋屈节旋迸抽锦抽萌触苔抱箨破玉披烟犀角穿壁森森箨龙玉版剥肤渐高迸犀露节破藓分枝侵篱带露马蹄出篱玉标林下并出裹玉破土如簪有节挺挺龙露角初出土姿耸壑干霄气金甲门前各生穿苔成林抱箨无心班班豹隐文欲凌云骨专车作竹时中小虚心见角牛羊没层层离锦箨成行齐婢仆玳瑁箨初解凤岂愁无食近舍傍穿壁外多粉节看皮虎豹存节节露琅玕环立比儿孙琅玕枝半疏龙方喜有孙依堂不碍云烟霁抽簪耸春寒解箨迟
木::碍日在庭乌迁郁郁蟠根蔽日根株万古危梢苍翠槎枒摩天绕屋鹊绕苍苍修干参天枝叶千寻老干青葱磥砢千重绿阴莺迁得地盘结浅黛晴烟锁千年固千重去不断繁柯低映地万丈翠干鸟择参天扶疏浓阴新雨过数亩阴一带景犹清直干上参天重叠琉璃叶凌云枝挺拔蜀柏逾千尺择宿看归鸟周遭翡翠枝蔽日叶青葱庄椿计几年迁乔认出莺照山霜醉烧空横浦晴辉照水秋色胭脂晚树经霜彩霞如醉横秋色千林霜后染一林如霞幔林端散余绮西风蜀锦秋山带雨红锦欲然染夜霜一树水边明千林似锦堆木杪绕残霞不扫悲宫怨似烧非因火新题寄御清如花不待春
叶::泥泥团圞团阴翠稠吟风莺巢浅黛匝地清阴布蓁蓁稠叠结荫绿暗蔽日蝉抱柔蓝连天翠色浓翠掩三竿日翠藻森如簇琉璃新剪就青园数亩烟鱼鳞细若铺翡翠密铺成遍山先零题诗飘零敲窗舞日落地初堕刻楮散乱逐水随风寄怨霜剪芳径庭前辞柯萧疏阴全薄飘飖舞时飞片几番经夜雨暗随秋月堕添愁风干斜阳林下点岸零落影半空零乱飞夜积团一半是秋风寒带晓霜飞听雨寒更尽零红碎锦树终日扫难尽静拥莎阶上木落秋容瘦闻风落叶声乱影下琼阶秋风吹又多闲堆草迳中林疏眼界宽
凤凰::六像九苞四灵授玺月穴翔风栖阁来仪冲霄鸣冈文彩朱冠五珍七德五采啣图紫庭蔽日巢桐览德舞镜食竹羽仪彩羽仙翰云仪应时魁羽族千金毛殊众羽呈异瑞轩律一声德辉始下九苞应瑞神翮风羽呈瑞灿文章五彩羽应昌期独高翔舜韶九奏群鸟后随五色成章朝鸣昆岭戈缀终无虑灵音谐律本去同君子道出者为王瑞苑竹多成实岂恋丹山乐夕饮醴泉梧桐止可栖彩羽应阳精来协圣人期见兆太平基宫梧几换枝应逢治世时
孔雀::五色金线红树三毛锦轮绿蕤翠羽锦衣元圃长尾峤南拖翠尾生远裔巢玉树贵为裘与蛇交瘴烟笼金花绣颈瑶池圆文陇右耸金冠集长门戏兰苕贱珥户逢牛触春雨滞杨修献赋开屏择婿产自罽宾千丝翠角钗股飘零鸳鸯水畔万里山川疏毛翻翠锦武相吟诗持扇登阶鸣如都护一寸珠光钿毫零落豆蔻阶前一身珠翠献尾拥华星奇毛宜饰盖金翠毛诚美日月移玄圃动摇云海影翠羽好为裘屏帏尾忽开云烟满故汀飞舞玉池阴
燕::入怀度柳差池金屋对对啣泥穿户系足穿花上下珠帘翩翩掠水栖簷画栋花间春去冲风朱户寻伴春分双飞牛巷柴门呢喃巷口拶云朱楼梁上秋来冒雨画梁趁巢秋社对语鸦村草屋来去堂前掠雨鸟衣巷寻旧主山查雨画帘阁花前语涩宫柳阴浓珠帘风自动语细声尤巧白玉楼结新巢野棠风细雨轻烟江上飞高水芹香细花迳雨初香衣轻舞更工绣户时双入风帘双过影花外陶泥去寻巢穿画阁华轩日几回画栋并栖身空中带雨回忆主望雕梁知时海天夜月别主如客红线应候云路秋风辞巢知归锦诗如诉别将飞反顾向人如告别振羽迷云水往来辞画阁巧语双双去四时无失序为谁忙欲去低回入户更低飞辞巢过锦机上下别朱楼能飞对对游八月自知归海阔迷烟渚楼高伴落晖
大雁::啣芦南来接武遵渚排行出塞芦岸云飞朔塞报候使者书恋稻北去来宾度云整阵横空蓼汀水宿衡阳寄书大夫贽红蓼岸莎汀晚离楚地宣王集芦洲宿处江南水阔影低寒渚晓惊商梦一行横紫塞白萍洲蓼岸秋入燕云汉武歌榆塞飞时漠北沙寒声漏秋风夜引孀愁万里入青云叫断江南梦望月惊弦影天寒一雁叫每爱秋天见寒临湘浦宿来通戍北情排云结阵行夜半几人闻偏愁月下闻暖望塞门归寄书一行排字几点字一行阵高先作字书千里行断不成文影只孤飞失侣单飞念侣声切伴月念群哀叫身单一点无群独立违群形孤搏风吊影凄鸣目逸望尽片影不饮啄长门晓高失伴失群鸣北陇更无声接续独奋凌云志心伤哀多孤音自飞鸣远戍霜独离群无伴过南楼空有影相随谁怜念侣声一声随落日数声疏雨外片影澄江水片影落寒塘一点断云中遥音大野风伴侣衡阳避雪喜晴来时远横斜关塞先花传信去路长带雨南离楚双双瞻客止依依前伴侣木叶程尤远和风北入燕一一背人飞历历旧山川梅花信可传
雉::朱冠飞鸣艾叶青压衔环绣颈饮啄绿花锦衣触树藻翰山梁朝飞雄雌升鼎绣羽低飞桑林下鲜如锦红绡剪出文呈五色易锦臆武库暮宿飞止进羡斑毛长雊麦陇中丽若丹赤玉雕成瑞入九苞难楚郊疑凤出绣衣翻草去幕历疏蒿下锦翼迎风鼓暮宿红兰暖陈宝若鸡鸣红觜啄花归毰毸浅草中朱冠映日鲜朝飞绿野寒煌煌绣翎金绶采采红觜采衣吐绶舞影云低艳吐临波疑濯锦聚冠呼群水宿光翻映叶似开桃
杜鹃::如鸠梦断故国一声夜听春暮啼血催归帝恨旧国年年千山月春城客化鹤更残深闺三月思归夜深诉冤伤别旅别旅魂故乡夜夜万古冤蜀帝魂愁客恨花枝上千万恨林外叫凄凉月山月冷口或涂梅望帝千年一声裂竹劝人归旅思中两三声枕前闻断续风野云深身常悬树天津三月半夜沾衣叫破三更月不堪啼血泪句句陈何事花残斑竹庙疏烟明月树蜀月将残夜惊回一枕眠又是落花天言言怨阿谁雨歇岘山亭微雨落花村巴山欲晓天
百舌::千愁花间巧语绀衣宛转睍睆圆转千般惊梦晓月饶舌侵晓语毛应翠万恨枝上奇声彩羽间关婉柔反复百转牵吟春风惊人傍春鸣语转新惊晓梦红雨村能缄口随百鸟声伤心孝绰发口过时花密藏难见知音兼众语起春情绿杨路祗报春啼三春月侍宴休文佞人在侧枝高听语新整翮岂多身能调一片舌枝头番双翼巧作百般声声调学众禽
啄木::铁觜除蠹劲嘴爪刚剥剥饥腹傍蚪枝云烟外珠冠投林健翎嘴利丁丁贪心开蠹穴风露中簷匐林中似僧敲户高傍古松有声当自振展开双翅绿翠翎衣日驭才离枯朽木琵琶市疑客扣门镇敲疏竹己饱莫生贪斜露一裆红红觜响烟罗又上最高柯
鸽::凌晨日下近人花毛锦背成群盘桓盘空飞去雨翅添砚映棘金眼薄暮云间傍屋线眼粉翎结阵摇曳认屋归来云翎听经传书锦毛将雏铃尤响清风习习自去自来雏能托梦日弄身边影一群冲日过飞去烟霄阔引类翅欲轻晓日迟迟相呼相唤子有挛生风饶尾上声数双拂云飞归来庭院幽锦毛殊可爱金眼实堪怜
鸠::催耕纹领斑衣呼雏彩彩刻杖拂羽食椹呼晴春晓择户唤雨花膺锦翼逐妇斑斑居巢降桑催种唤雨秋残唳天雨后知阴晦资鹰化集白水社前社后苏轼诗中颈上玉花春惊梦客一世为巢拙风前喜晴明夺鹊巢献邯郸山北山南徐熙画臆前檀粉秋恼羁人长年与鹊争农务村村急林鸣对对忙
鸦::慈鸟上林牛背护巢投林纷飞接丸茅庵乱噪催画角孝鸟乔木城头接翅报捷乱噪反哺桂殿群飞送残晖凌晨噪成阵集暮雨天催晚照争噪翠烟乌帻剪衣屋角鸣朝日万里盘风下入夜啼结群飞晴月夜报秋寒乱翻红树玉环穿项林端噪晚风高林接翅眠残阳声转切夜宿归乔木明月夜无依朝飞集丽城
雀::占爵化蛤持环引雏噪簷争枝跳梁却火应瑞鼓翅嘐嘐簷前翅短衔书依人贺厦入幕穿壁贪食踊跃知更报恩成群啧啧林上身长啄粟喧暖日晴暄松杪群本鹪鹩雏犹黄口啄粟声尤噪聚噪斜阳外营巢安厦宇负喧噪晴天寒啄梅梢志殊鸿鹄瑞有白翎争枝翅更忙群飞暮雨中得食喜阶除衔书表周瑞入幕应王祥
鸳鸯::翠鬣红衣绮文红毛纹羽翠翘玉沙蓼岸花屿双飞交颈共游烟岛苔矶有机心绣绿翠羽花毛红颈锦翅兰皋苹洲并宿同心双宿寒塘蓼浦无别恨眠沙稳入林池排荇带莫打鸭儿韩冯埋处两两珍禽浮波弄影柳塘林映日浴浪稀解玉佩拂菱华谁抛莲子霍氏园中双双锦翼刷雨乘风花坞晚浮烟共泛银塘润相随皆配偶文采负奇色溪头晴浴浪双栖锦羽鲜共戏合优悠和鸣多好音渡口暖眠沙
翡翠::柳岸翠翎怜羽静立竹林丹嘴列巢惊飞鸣竹逐匹窥鱼聚冠水边鸣高竹据溪田巢玉楼好聚鹬冠翠惟六翮白苹洲渚穿花归巢照水饰服花上别长门鸣衣桁备宝帐珍同豹舄羽值千金碧袖娇娃柳除偏得意久停芳沼立竹密但闻声才得锦鳞飞
斗鸡::介羽刚戾介翎杰毛奋击腷臆疏身先鸣昂尾狼顾侧行跃身横行轩昂金距勇颈怒撄峥嵘怒目侧睨高冠鸾翔俯啄碎首英心怒势勇退高行高鹰峭峙勇同刘项敌悍目壮心疾前侧视双翅齐平势入孟韩诗
鸭::尚阳眠沙缓行池中红足踏水浴浪侧卧江上花毛低声绿头浴水眠沙毯缨采采头惊白游青水春雨萍开宜铺茵褥畜从富氏缓步红掌连泥蹈浪梯翅斑斑毛讶长浴白波荒陂船护莫打鸳鸯养自吴王冲萍浮水绿并戏争浮梗羽毛知独立晚游清水去朝游随鹭伴地小聊堪泳攒藻带泥香斜飞避小舟黑白太分明暮浴白波归晚食入鸡群天高未可摩
麒麟::奇姿表瑞戴义仁兽以德花纹牛尾应嘉瑞止不群出周郊来轩圃仁趾呈祥含仁水精为灵肉角马蹄出明时行无侣修鲁史步禹庭对羡终童帝阁图形大角垂象瑞首四灵含仁知善应在郊怀至治角生虽备武歌传汉帝仙家劈脯元枵降珍名尊百兽表德亦无伤游野化深仁肉戴示深仁矩步规行迹画像临仙阁含仁抱义情藏书入帝台
狮子::伏狸钩爪铜头鼻仰奋髯绀眼威虎豹毛起焰搏象锯牙铁额目圆吐舌赤毫慑熊罴眼悬星毛耏耏尾斗形声若电鸣犀兕潜惊表异昆鸟弦安息献来霜牙煇陛戟出柙方疑虎耳帖帖毛金色目如电发貔貅股悚若奇蝇拂昆仑养处金毛飒庭茵修身宛似麟遐荒钦汉德猛鸷服尧仁
虎::电目愬愬负嵎豹变妥尾横行钩爪猛气狰狞长啸摇尾雷威眈眈啸谷牛吞磨牙震怒锯牙雄威猛烈斑皮决蹈渡河蹈尾炯炯低头电威随武呼李耳高崖才发啸炳文同豹变雷吼千岩震出界编须哮哮闭目雷吼凝姿唤波卢绝壑自生风鼓勇破狐疑风生万壑雄怒震千山外文炳斑三锦莫负编须勇名居百兽先牙磨凛二霜须怀履尾虞
豹::文革享金钱炳蔚食铁变虎为韬千金质斑毛艾叶烂斑辟邪食牛学艺七日藏大夫饰窥管中殊鼷鼠生雄三子隐南山雾委质超羊革享还将君子变食牛新志气天子旌称果下异犬羊死擅千金受北国皮飞名列虎侯来蕴太公谋变虎旧文章隐雾当年迹成文此日斑
象::燧尾役鼻致远高形昆阳率舞泣子金函渡河伊水交趾献来焚躯藏牙代耕良鼻祖道助威哀雌宝座行陆荆山历山耕去教战诚无敌奔师因燧尾脱牙如削木万推方溟梦充庭实可佳有齿反焚身运鼻似垂云惠子正焚书
骆驼::奇畜识泉取经凌云显功负重奏事蹈雪渡沙鸣风一卦识风生负千斤生天竺肉有鞍献周时夹铜马背耸双峰出塞如水四足知泉脉行七百出泉渠毛成褐置唐驿悬灵龟足弯三节养鱼盛水朝士起立渡沙知水脉并途逾百里负多殊不倦汉驿凌云去当时识风候立雪屏风番僧抚摩入塞识风声任重负千斤行远未应劳胡人蹈雪牵过碛辨沙泉
马::宛西践雪雄姿如龙污血金羁奔星嘶风登山狰狞八龙乾象骐j 廾冀北追风壮志似鹿霜蹄玉勒流电嗅雨弄影蹀躞九逸坤贞骕骦火德赤兔局辕九龙入画神骏困车空群三物万里走玉关辞汉月河精乌骓泛驾八骏披图权奇伏枥服皂八坊五花纹沙塞蹈胡霜来从西北道望云时蹀足竹批双耳峻去逐东南隅向月每争雄风入四蹄轻力衰伏枥岁久力将衰志千里神弱垂头力微形尚劣鬣半番草深闲楚泽毛骨从前贵力尽忆胡沙关山欲去赊瘦骨泪眼毛焦无润龙骨瘦步难进尾蟠夜雨伤心疮皮力惫独寒兔毛干泪已垂头瘁秋风尘中老尽力岁晚病伤心喷云飞腾一鞭似练蹄似追风去飞练奔轶千里如风影如逐电来
驴::长耳奇畜雪径嗅地绛身名驹花村笑天负磨云间骑碧郑圃草丛青衫跨出笑倒陈抟谁敲月下慢登溪路熟野水深能渡掉臂梦衫红灞桥风雪素服乘来供名李白赎罪松声急过水桥生霜桥滑亦行
牛::文角伐蜀东皋燧尾耕云其犉婿争载土白角尊元武乞生遍拜花蹄破燕南陌运粮喘月在涤叔射乘车鲜毛重太牢惜死哀号宁戚商歌日带露眠芳草不羡庖丁解田单尽策时和烟入甫田方思渤海贤骨瘦瘦弱舐犊树下原上瑞万顷春耕田肥鞭笞负犁槽边陇头春一身寒苦都为耕犁苦负犁非一日颈穿空自惜致令筋骨衰牵缰几何年骨瘦有谁怜丑地裂肤应节班春鞭击碎身春时粉骨立春饯岁人争及物彩纹形骸随意就欲送寒威尽一村纷转急休喘青霄月绘土颜色按年先催农事忙三绪免耕耘难耕绿野春
羊::贲首短角轻蹄化石柔毛长髯美质驾车触籓卧沙芳草食麦挟策借书千足挥肱种脐见豺身易战触藩难进退跪乳在牧平原献羔补牢换字多岐羸角割尾窥豹革享难同荷箠易东西易悦风前草难干雨后身
鹿::食柏衔花修角呦呦噳噳作对挟毂走险六飞触松归远洞饮泉眠草斑毛濯濯甡甡成群游台无虞四驾犯柏过长林饥寻药圃道士乘仙日园啣花去渴饮云泉先生折角时洞前嚼豆还
狐::昼藏依林九尾听水性疑玉面青丘昏见处穴千年吹火情媚绛缯黑水髡髻向穴嗥戴髑髅威假虎称道浴皓首书生报幽岩客变成美女晨兴宜穴处掷头篝火鸣迷美女黠凭城放伯裘元邱校尉入董生帷啼学婴儿昏见必郊行千年形已变风嗥青嶂外水渡忧濡尾三德性先灵雨啸古林中风嗥乐在梁
兔::东郭守株月魄三窟越壑在腹玉骨广寒捣药星精千年腾山忘蹄霜毛趯趯仙山入宫汉月澄秋色日随槐叶长一株休更守捣药元无死爰爰月殿赴苑梁园映雪辉形逐桂枝飞三穴已深藏忘蹄始见渠
猿猴::鸣峡挂枝拔箭孤吟啸云接臂蓦山黄练赤绩献环引愁掷瓦月下蜀门眠向日号弓长啸饮涧拥条逾涧白纱朱巾拥树惊梦断肠江边湘岸啸依风穿云宿处月照山堂静巴峡供愁思啼破三更月远寻红树宿望月啼时风传雪涧深阳关惹泪痕声悲五夜风深入白云啼
犬::附书摆尾恋主吠雪摇头丧家迎客展草三种续貂累累雄姿累百易曾称小畜舐残丹鼎药吠人衔衣二师吠日狺狺猛相成群书复载灵獒飞出白云乡
猫::快捷捕鼠斑文双眸侧睨蹲窥啣蝉钩爪四爪闲眠眼活捷牙铁笼微奇穿柳盻来玉局闲翻既号麒麟花阴昼静征梦堂前哥既称仙毛柔利爪火星表异褁监迎去纱帷密贮莫残鹦鹉竹簟朝慵图形芥肆奴还名女足蹲鼠动夜护书窗卧毡殊可爱毋令童子惜声应人呼威名鼠将捕鼠最堪怜终得妇人怜
鼠::夜动拱穴居侧盗肉白衣舞门昼藏翻盆穿墉食禾绛帻守室饮河啮马鞍号夜猴衔炷成灾斗穴窃祀物名地拍褁珠报德
龙::升天云腾雷惊天隅飞腾吸雾在沼云从拏云跃渊四灵三池济旱鱼化电击海表变化呼风冲天雷化驾雾战野五色五采腾云露三级浪能拔萃飞千里杸梭雷泽剑化经何地禹浪三层透腾身脱渊水跃天池一声雷利乘干上九重挂杖葛陂梭飞几度春商霖四海苏举足上云津头角人间秀精神天上身
蛟::小头交尾枕石化龙上云霄化小童骨青无角怒起拏云次飞入水细颈连肩裂山食虎求天雨成美女瘦白成围寒藏秋水周处操戈汉武射江澹台投壁
鱼::结网盈车涸澈红尾依藻含饵游泳泼泼偎荇波浅鼓鬣浮沉漏网忆鲈钓渭暴腮青鬐冲萍吞钩深沉洋洋弄萍浪悠扬鬐追逐忘筌跨鲤观棠跃舟丽罶獭祭锦鳞依密藻相逢七日泼刺银塘翻藻抛金尺水底情何逸牣沼施罛鸿离玉脍动新荷能钓千年悠扬玉浪中依蒲漾玉梭波间乐自如闻琴应鼓舞漏网信夷犹
蛇::涸泽吞象合药螫手画足深山两头钩牙掉舌翻红燄常山化龙衔珠伤肱脱皮大泽百毒呥舌盘身蹙白花大能吞巨象藏笥新嘉庆休轻脱蜕晚长可绕昆仑含珠答厚恩必有化龙时
龟::曳尾石肠国宝吞气左顾负图十朋涂泥元甲神司含灵决疑游沼五总灞水养气置室赤文纪庥锡范游卷耳决七疑游莲荷能知物阴阳数具灵池含神支床朱字衔符披图伴灵蓍无遗策饮桂露反害身造化机含位方居坎神物高凡品甲虫惟独长有灵能灼物用能占治乱占象应离灵机决大疑水族最为灵无智解藏身端可卜安危谢惠四灵衔珠报恩三顾铸印酬恩中流足蹑休入网月夜应同见报德左顾头回切放心雪天难觅踪
蛙::绿衣碧草清泉惊梦纡紫井底喜能鸣锦袄绿苔白石聒人拖青柱中怒堪式青草岸奇夸吐水足四足三且容当鼓吹呼名徒自喜乱鸣深井月中唯见影绿荷洲厄受抱竿为官为私慎勿问官私怒目为谁嗔群吠古池中雨后只闻声
鱼虾::蝗化善游海马草屩捞来谢豹名佳形披白角一双红筋授耳献珠龙形好跃沙虹稻花变出江瑶味匹身作水晶几股花簪长须求婿
螺::象离为杯居坎饰镜出蓬莱休测海台可筑曾经素女头旋似髻难寻阚泽似鹦鹉学闭门舟自沉自说原神掌细如纹须避刘臻
蚌::珠胎江珧锦背花斑明水海月素唇玉洁解醒盈虚随月水上张帆罗汉潜形谁游五岳璀璨色如玉含浆不肯吐荐俎变化成楼海中挂席龙蟠留迹目出双珠斑烂点作花得火遽能呀细如鳞白似雪赵后帐中颖川水珂珮绳穿隋皇几上东海潮来方诸水滴
蚕::成茧五色冰蚕树五亩桑劳妇力功成供织组作茧非身利青桑初破眼吐丝三眠斗尔虫趁三眠茧报君恩寒至备衣冠成丝济岁寒绿蚁渐盈盘食既资桑柘功能被古今
蝉::鸣榆吸风噪晚应节八名绿槐爽月断续雨后翼薄凄凉噪柳饮露吟秋居高五德高柳斜阳凄清风前蜕转萧瑟说露牵恨形微枝头临风声尤切吸朝露秋晚孤冷渐渐凉风清吟朝露叶谈风感愁声响叶底入耳韵转清咽晚风夕阳乱噪飕飕冷气秋噪夕阳枝古木秋风急荒城悲远客淡云青草露夕阳千万树栖凉依古驿青山客路长古驿送残阳落日碧山城林吹两三声哽咽怨残阳疾徐遗壳呜咽清音应候风轻薄露凉夜脱壳江村晚千万树栖桐叶如仙骨换新声惊客梦报秋飞远乍鸣曙天饮风柳岸秋两三声噪柳枝似道心清初韵惹乡心
蜂::口甜趁暖群集穿花粘絮日暖胜露腰细风光君臣义花正盛门临花圃尾利报衙纷飞殢柳带花春深倚风身轻景致南北衙蜜尤香架近松窗报衙声闹衙分朝夕带柳随风舞蜜房无尽乐群飞分上下报衙声更闹痴意志烟重采蜜翅忙义尽尊卑沾花镇日忙花室不胜情类聚别君臣采蜜翅应忙游心任雨沾香迳飞还集芳丛去复来
蝶::粉翅凤子翠绀金钱偷香柳幕对舞芳情搜红经春翅残琼须春驹紫斑玉屑傅粉花房往飞雅态访绿破晓力困红醉粉牵懒舞冉冉庄叟梦化罗裙能生媚丹青树上滕王榻罢捉放宫人绿眠香惹慵飞翩翩韩凭魂分蔬叶解高飞彩缕宫中谢逸诗成香随妙妓重傅秦楼粉陌上斜飞去拂柳香须战乱逐枝头绿玉罗裁剪翅轻涂汉殿金花间倒翅回穿花粉翅轻往寻叶底黄金线染春须拘枝薄命怯露多情有情力困秋风霜丛怯冷怯寒沾宿露翅残愁雨湿懒攀高槛舞露叶今非昔无力飞慵寒露露叶难飞喜暖趁朝辉力困怯风吹空恋落花香霜丛畴可依
蜻蜓::点水对对亭亭薄翅不定双飞往来逐风畏日成群云母翅名白宿舞风双双款款纤腰自由独立上下迎日炎天衔尾碧玉睛字青亭相逐戏迎暖日红香内皎绣户枝堪缀足食尾弥甘随风上下碧玉光睛眼翅薄飞时急斗高飞逐和风绿影中弄晴晖叶好藏身埋头起舞点水高低香罗薄翅衣腰纤舞更高舞风秋过雨点水回环匝池畔亭亭立点水喜初晴随风上下忙空中款款飞
蟋蟀::空阶向外系紫泣露催织草根暗壁迎阳拖黄吟风悲秋床下风清惹愁细韵林下入林长须秋深风静夜惊妇懒鸣东壁入金笼蓑衣锦色月冷牵恨清吟野中在户纤股岁暮月明时动客愁振西堂代玉管束带金装近人知在宇窗下金风冷无风来竹院一声微转轴应候自鸣秋庭前玉露寒有月下松庭万响细牵丝
促织::断续弄杼草底泣月凄清催机砌边临风生愁思轩窗觉冷低头向嬾妇风清人静夜虽作痴儿戏贫家多赖汝动旅怀机杼催忙鼓翼学天孙露冷月明时偏为懒妇愁富室不由伊
蛩::砌畔庭前窗前草际月明切切雨天秋深知时引愁草上居壁伴枕石阶床下韵秋风夕霜冷悲悲月夜夜静应候聒梦窗间鸣阶鸣窗莎草壁间吟夜雨时凄凉当半夜冷韵微依户似有催寒意不独寒蝉韵切切亲床枕声声动闺怨断续识三更寒声细乱阶且含带露声能令懒妇惊频频见岁时夜夜惨离愁
蜘蛛::设机轻微簷前作巧织网依户吐丝累腹网公壁隅连琴傍珠帘黄花毒螫害物机巧雨后乘虚张罗漫天报喜饥心络妇槛曲蒙幂杂花幌青鸟长蚑垂户丝常坠风飘多散乱屈曲连还续贯穿丝取密孤踪劳结网依廊网密张雨缀甚轻盈团圆密又通经纬织尤工一缕布空虚
萤::破瓦荒榛却马颓垣蔓棘辟兵照书昼伏来往荧荧腐化草际烟昏随风数斗照苔迳杂渔火映水飞来隔幙夜飞高低点点星流风前露湿穿月一囊点莎庭乱流星疏帘巧入的皪流光小夜风吹不灭含光终不息映水光难定始因腐草出过池星入水飘飖弱翅轻秋露洗还明入夜自能飞凌虚体自轻素负照书功沿树火燃藤
蝇::集瓜青翼集盘营营逐气呼朋止棘红头附骥扰扰寻香引类残滴逐臭搅寐刷翅挥不去污白璧寻头扑面冰至宁来聚散长惊扇怒剑应难逐余腥趋膻剌谗摩头逐还来负黄金舞袖穿裳鱼驱何益高低每避人疑琴莫乱弹群飞当盛暑只解寻香至但知香与臭迹灭向坚冰安知逐剑飞不识是和非
螳螂::臂奋轻身名拒斧逞贪心庄叟嗤首骧长颈象天马奋勇力齐君式深秋乳子含气生火秋蝉遭捕举足抟轮仲夏方生执翳潜形异鹊相寻怒臂拒辙
蚁::穴居形小溃堤列阵元驹纷纷群聚力微封穴成行白蚁扰扰队伍上梨战斗穴处情何逸自识君臣义慕膻应列阵可是能知雨慕膻应有意君臣编竹尊卑群居性最灵难忘战斗心移穴自成行由来喜慕膻溃岸信无心断续缘高璧周遭避浅池
蚊子::长嘘长喙黍民聒梦噆肤雷声扰扰成雷挥扇喓喝炎天短吸细身白鸟惊人聒耳豹脚营营扑面薰烟贪婪暑夕一粒挥不去性惟贪口腹粒身生羽翼暗中难见影饱去樱珠重通霄拂还来人已刺膏脂针喙噆肌肤静里忽闻声饥来柳絮轻
灯蛾::投光赴烛就火飞明忍死灭灯附炎随光至被眼瞒自厌生身投高烛方脱吞炎志想因怀暗昧轻生扑烛触焰入夜来将身误无惜死翅扑短檠还遭烂额危无复近光明终思来暗处向明虽有意顿起讨炎心忍死奈无功
